"","ArrTime","DepTime","FlightNum","ArrDelay","DepDelay","TotalDelay"
"1",1554,1443,428,44,43,87
"2",1553,1443,428,43,43,86
"3",1634,1530,428,84,90,174
"4",1622,1507,428,72,67,139
"5",1553,1441,428,43,41,84
"6",2207,2100,533,47,55,102
"7",2155,2045,533,35,40,75
"8",2229,2119,533,69,74,143
"9",1951,1835,1121,126,125,251
"10",1855,1752,1121,70,82,152
"11",1819,1708,1121,34,38,72
"12",2235,1934,1294,80,99,179
"13",2156,1848,1294,41,53,94
"14",2154,1839,1294,39,44,83
"15",2146,1828,1294,31,33,64
"16",2211,1905,1294,56,70,126
"17",2209,1856,1294,54,61,115
"18",1113,941,1436,48,31,79
"19",1454,1134,1700,74,74,148
"20",1358,1255,1820,48,50,98
"21",2228,1938,731,78,73,151
"22",2110,1639,622,61,54,115
"23",2200,1801,622,111,136,247
"24",2057,1618,624,57,43,100
"25",1229,808,620,72,68,140
"26",2056,1647,624,56,72,128
"27",2135,1725,624,95,110,205
"28",2118,1659,624,78,84,162
"29",1647,1422,146,64,77,141
"30",2,1949,310,33,49,82
"31",2118,1911,421,80,91,171
"32",53,2157,467,58,42,100
"33",2349,1940,732,44,50,94
"34",2056,1754,1086,97,114,211
"35",1203,935,170,49,45,94
"36",2046,1813,421,48,33,81
"37",2128,2004,423,54,39,93
"38",2159,1931,670,41,41,82
"39",2335,2026,755,61,55,116
"40",2002,1700,1086,43,60,103
"41",2109,1931,1099,37,31,68
"42",1559,1127,1476,82,63,145
"43",1515,1319,1605,51,40,91
"44",2,2234,1717,89,94,183
"45",2324,1944,1748,53,39,92
"46",1805,1704,1787,58,69,127
"47",1445,1045,1,55,80,135
"48",1202,1010,220,61,65,126
"49",1157,942,309,33,52,85
"50",2346,2010,426,45,60,105
"51",2151,1933,709,73,88,161
"52",1916,1516,1,326,351,677
"53",2034,1614,62,97,109,206
"54",10,2022,426,64,72,136
"55",2351,2034,500,61,69,130
"56",2301,2100,670,102,129,231
"57",31,2154,770,77,61,138
"58",1833,1709,795,65,89,154
"59",1323,947,1058,35,54,89
"60",1522,1059,1476,48,37,85
"61",1710,1400,1548,31,45,76
"62",2051,1637,1676,54,52,106
"63",1622,1504,1695,76,109,185
"64",1833,1740,6,98,105,203
"65",2135,2017,59,143,162,305
"66",1945,1822,137,210,234,444
"67",2254,2137,150,219,242,461
"68",216,11,209,137,168,305
"69",153,2237,250,208,227,435
"70",1604,1336,267,45,61,106
"71",2308,2140,299,42,46,88
"72",20,1954,310,51,54,105
"73",1524,1423,323,61,68,129
"74",1627,1245,406,35,45,80
"75",1621,1102,510,181,127,308
"76",2135,1945,520,114,125,239
"77",1842,1419,532,57,59,116
"78",1827,1450,534,104,110,214
"79",2036,1849,570,31,64,95
"80",2203,1730,632,110,105,215
"81",2153,2008,670,35,78,113
"82",39,2039,732,94,109,203
"83",2202,1527,810,267,137,404
"84",2325,1902,1010,65,72,137
"85",2216,2133,1411,134,148,282
"86",1607,1203,1476,93,101,194
"87",136,2128,1632,216,231,447
"88",2038,1642,1688,45,42,87
"89",2313,2206,1717,40,66,106
"90",1711,1543,1821,41,63,104
"91",1722,1302,1836,36,32,68
"92",1944,1531,62,47,66,113
"93",1816,1325,106,181,160,341
"94",1550,1130,432,44,45,89
"95",1633,1146,510,193,171,364
"96",1909,1443,532,84,83,167
"97",1436,949,776,180,144,324
"98",1820,1341,810,45,31,76
"99",2332,2238,1479,88,94,182
"100",1746,1431,1548,67,76,143
"101",1906,1502,1836,140,152,292
"102",1802,1706,35,94,91,185
"103",2058,1930,59,106,115,221
"104",2244,2002,616,43,52,95
"105",2129,1712,682,52,82,134
"106",2115,1855,709,32,50,82
"107",43,2112,1488,92,112,204
"108",1507,1334,1629,60,74,134
"109",1605,1144,1,135,139,274
"110",1947,1812,150,32,37,69
"111",2325,1931,250,56,41,97
"112",1720,1421,400,43,66,109
"113",2103,1837,570,58,52,110
"114",2345,1943,658,51,38,89
"115",2051,1807,667,48,42,90
"116",2157,1911,709,74,66,140
"117",2342,1927,732,37,37,74
"118",2059,1939,1411,57,34,91
"119",1352,1102,1646,49,32,81
"120",1952,1835,1705,58,60,118
"121",2025,1925,5,51,60,111
"122",1440,1127,1448,38,47,85
"123",1648,1510,137,33,42,75
"124",1448,1319,197,49,42,91
"125",1512,1116,788,74,60,134
"126",2040,1737,1086,86,97,183
"127",1750,1306,60,77,61,138
"128",1835,1416,532,50,56,106
"129",1918,1615,606,34,35,69
"130",2233,1801,632,140,136,276
"131",1736,1614,697,86,94,180
"132",2304,2212,1423,53,67,120
"133",2243,1940,1506,37,40,77
"134",2352,1911,1632,112,94,206
"135",1723,1606,33,49,41,90
"136",2139,1957,47,34,43,77
"137",807,635,59,775,780,1555
"138",1947,1539,62,50,74,124
"139",1153,1008,220,47,63,110
"140",1816,1622,275,55,36,91
"141",6,1938,310,37,38,75
"142",1716,1509,320,45,39,84
"143",2047,1814,421,49,34,83
"144",1705,1535,599,63,69,132
"145",2132,1807,667,89,42,131
"146",1836,1628,795,68,48,116
"147",1951,1826,1674,45,33,78
"148",1544,1359,1695,38,44,82
"149",1950,1807,59,38,32,70
"150",1150,1019,199,163,174,337
"151",1251,846,332,38,61,99
"152",1721,1328,458,36,33,69
"153",1653,1533,697,43,53,96
"154",2236,2144,1479,32,40,72
"155",2042,1901,59,90,86,176
"156",1223,817,89,123,137,260
"157",1432,1017,232,41,57,98
"158",1325,846,408,70,56,126
"159",2243,2004,444,44,44,88
"160",2022,1547,532,157,147,304
"161",2346,1843,632,213,178,391
"162",2142,1634,682,65,44,109
"163",29,2011,732,84,81,165
"164",1808,1522,746,68,62,130
"165",1911,1700,1070,51,60,111
"166",2228,2052,1099,116,112,228
"167",2034,1950,1411,32,45,77
"168",2330,2225,1423,79,80,159
"169",2150,1805,1546,105,37,142
"170",21,2000,1632,141,137,278
"171",2339,1928,1676,222,223,445
"172",2038,1918,1689,61,81,142
"173",10,2002,1776,42,47,89
"174",1815,1359,1832,125,134,259
"175",1900,1455,1836,134,145,279
"176",1244,1108,52,193,203,396
"177",2002,1551,62,65,86,151
"178",1928,1644,146,225,219,444
"179",1,1952,310,32,52,84
"180",2321,2047,444,82,87,169
"181",1746,1501,546,204,196,400
"182",2241,2000,616,40,50,90
"183",2158,1848,667,115,83,198
"184",1544,1239,686,116,124,240
"185",2109,1838,746,249,258,507
"186",3,2131,1046,36,36,72
"187",2226,1932,1546,141,124,265
"188",1542,1303,1646,159,153,312
"189",1153,928,170,39,38,77
"190",2107,1910,421,69,90,159
"191",1609,1508,623,32,38,70
"192",2100,1757,667,57,32,89
"193",2318,2030,755,44,59,103
"194",2026,1911,1511,34,71,105
"195",1046,635,89,34,35,69
"196",1559,1140,432,39,40,79
"197",2106,1831,667,68,66,134
"198",1731,1348,744,45,38,83
"199",1932,1527,810,125,137,262
"200",2028,1939,1411,31,34,65
"201",1506,1117,1,76,112,188
"202",47,2207,209,48,44,92
"203",121,2127,310,112,147,259
"204",2135,1753,410,40,50,90
"205",4,2301,597,96,123,219
"206",2101,2014,1674,115,141,256
"207",1215,818,89,115,138,253
"208",1234,1004,170,75,74,149
"209",1800,1541,370,69,76,145
"210",26,2146,467,31,31,62
"211",2056,1816,570,51,31,82
"212",23,1927,582,50,32,82
"213",1550,1420,663,148,175,323
"214",2248,2029,670,90,99,189
"215",1842,1731,763,39,36,75
"216",40,2148,770,86,55,141
"217",1924,1711,1070,64,71,135
"218",2155,1958,1889,114,138,252
"219",1951,1503,62,54,38,92
"220",937,709,446,63,69,132
"221",2213,1917,709,90,72,162
"222",1723,1603,33,49,38,87
"223",1022,838,52,51,53,104
"224",1916,1638,146,213,213,426
"225",1956,1815,150,41,40,81
"226",2315,2001,190,32,41,73
"227",2300,2004,444,61,44,105
"228",2237,2003,616,36,53,89
"229",2040,1805,746,220,225,445
"230",1800,1506,767,41,31,72
"231",2220,1944,1546,135,136,271
"232",1727,1442,1646,264,252,516
"233",1041,807,1746,41,42,83
"234",2137,1941,47,36,31,67
"235",2318,2009,190,35,49,84
"236",1807,1150,212,102,95,197
"237",2153,1727,682,76,97,173
"238",1721,1417,786,33,42,75
"239",1106,917,799,39,32,71
"240",1,2040,1488,50,80,130
"241",2037,1802,1546,32,34,66
"242",2147,2019,1715,162,164,326
"243",2031,1815,1858,38,37,75
"244",1737,1634,6,42,39,81
"245",2208,2012,47,66,61,127
"246",1953,1814,59,41,39,80
"247",47,2220,209,48,57,105
"248",1710,1115,212,50,60,110
"249",5,1946,310,36,46,82
"250",2241,1850,410,106,107,213
"251",136,2312,467,101,117,218
"252",2151,1935,520,130,115,245
"253",1635,1531,623,58,61,119
"254",2349,2019,644,72,84,156
"255",2228,1938,670,70,48,118
"256",13,1949,732,68,59,127
"257",1623,1522,1079,36,37,73
"258",2000,1654,1086,41,54,95
"259",1654,1536,1589,37,54,91
"260",1504,1312,1605,40,33,73
"261",1425,1234,1620,51,59,110
"262",1617,1500,1621,37,40,77
"263",2237,1822,1632,37,39,76
"264",2331,2029,1662,70,79,149
"265",2031,1623,1676,34,38,72
"266",2126,1938,1711,57,37,94
"267",2325,2147,1717,52,47,99
"268",1030,812,1746,35,47,82
"269",1931,1826,1779,51,47,98
"270",1709,1344,1850,37,49,86
"271",1449,1319,1882,85,109,194
"272",1931,1515,62,42,50,92
"273",2259,1951,250,39,61,100
"274",1811,1659,275,70,89,159
"275",1514,1416,379,57,56,113
"276",1553,1124,1476,86,64,150
"277",2300,2200,1479,57,52,109
"278",1642,1530,1589,33,51,84
"279",1406,1212,1620,32,37,69
"280",2258,1945,1748,32,40,72
"281",1831,1321,1836,110,51,161
"282",1452,1055,226,33,35,68
"283",1549,1127,232,118,127,245
"284",1445,1351,241,47,46,93
"285",1731,1255,432,145,130,275
"286",2150,2057,479,94,107,201
"287",1109,959,497,36,54,90
"288",1736,1414,786,48,39,87
"289",1516,1108,1476,42,46,88
"290",1654,1524,1589,37,42,79
"291",2019,1850,59,67,75,142
"292",1712,1422,206,68,82,150
"293",1346,1214,297,98,99,197
"294",48,2040,310,79,100,179
"295",1729,1505,370,38,40,78
"296",2305,2034,444,66,74,140
"297",2154,1922,670,36,32,68
"298",2338,1920,1010,78,90,168
"299",2036,1833,1511,42,31,73
"300",1509,1302,1629,62,42,104
"301",10,1959,1776,42,44,86
"302",1751,1644,1787,44,49,93
"303",2017,1832,1795,45,47,92
"304",1614,1347,146,31,42,73
"305",2318,1957,644,41,62,103
"306",1758,1512,767,39,37,76
"307",1204,950,771,124,140,264
"308",2016,1828,1795,44,43,87
"309",1950,1814,59,38,39,77
"310",1647,1509,137,32,41,73
"311",1951,1818,150,36,43,79
"312",15,2009,310,46,69,115
"313",1743,1527,370,52,62,114
"314",2023,1821,520,42,41,83
"315",2109,1853,570,36,48,84
"316",944,804,1097,47,34,81
"317",2308,2205,1423,57,60,117
"318",2040,1807,1546,35,39,74
"319",2158,1946,1558,57,36,93
"320",2259,1930,1586,47,35,82
"321",2050,1922,1711,32,32,64
"322",2018,1829,1795,46,44,90
"323",2011,1837,59,49,52,101
"324",1647,1500,137,37,35,72
"325",2126,2005,297,40,50,90
"326",2056,1949,423,37,39,76
"327",2131,1937,520,106,112,218
"328",2053,1840,652,31,35,66
"329",1450,1321,738,48,51,99
"330",2338,2146,820,46,51,97
"331",1440,1248,1620,61,73,134
"332",1542,1352,1695,37,37,74
"333",1922,1827,1779,31,37,68
"334",2033,1842,1795,51,47,98
"335",1648,1557,35,31,32,63
"336",933,836,128,55,66,121
"337",1657,1456,137,47,31,78
"338",1629,1414,146,39,59,98
"339",1242,1011,170,87,71,158
"340",1450,1233,252,74,73,147
"341",1834,1558,370,114,93,207
"342",1944,1832,397,49,67,116
"343",1840,1721,399,89,106,195
"344",2129,2003,417,40,53,93
"345",2230,2130,423,54,60,114
"346",2145,1930,489,71,80,151
"347",1814,1539,509,42,44,86
"348",2157,1947,570,117,127,244
"349",1648,1527,599,48,62,110
"350",3,2125,670,144,140,284
"351",1838,1738,763,31,38,69
"352",122,2310,770,118,126,244
"353",2327,2138,820,35,43,78
"354",1514,1208,1006,72,68,140
"355",1541,1444,1079,31,33,64
"356",2329,2222,1423,73,72,145
"357",2141,2054,1441,104,114,218
"358",1507,1122,1476,32,57,89
"359",18,2207,1546,164,192,356
"360",2351,2051,1662,85,96,181
"361",2332,2208,1704,64,63,127
"362",2029,1834,1795,47,39,86
"363",2106,1933,150,49,51,100
"364",1214,935,170,59,35,94
"365",1420,1205,270,40,40,80
"366",2304,2015,500,42,70,112
"367",2103,1725,558,62,70,132
"368",2316,2028,670,54,35,89
"369",2117,1856,709,34,46,80
"370",1231,1107,739,109,117,226
"371",2019,1710,1086,65,70,135
"372",2323,2149,1597,38,39,77
"373",53,2250,1644,109,120,229
"374",1513,1145,1690,54,52,106
"375",2000,1709,8,59,71,130
"376",1013,721,1960,43,39,82
"377",2104,1758,8,121,119,240
"378",1451,1154,1512,64,64,128
"379",1340,1038,1900,210,218,428
"380",1952,1657,8,49,58,107
"381",1230,941,1248,223,236,459
"382",2035,1737,1590,487,488,975
"383",1033,737,1960,63,55,118
"384",2225,2036,4455,100,131,231
"385",2159,2009,4455,74,104,178
"386",2155,1930,4455,70,65,135
"387",2315,2215,1118,67,70,137
"388",1312,927,1120,124,122,246
"389",1422,1053,1120,194,208,402
"390",1048,851,1138,84,86,170
"391",2017,1855,1112,45,47,92
"392",2043,1927,1112,76,79,155
"393",2006,1843,1112,34,35,69
"394",2325,2159,1114,55,49,104
"395",2302,2151,1114,32,41,73
"396",1124,1016,1124,48,41,89
"397",1151,1054,1124,75,79,154
"398",1648,1540,1125,65,55,120
"399",2355,2017,1127,40,35,75
"400",16,2045,1127,61,63,124
"401",2354,2025,1127,39,43,82
"402",2043,1918,1112,71,70,141
"403",59,5,1118,171,180,351
"404",2010,1817,1144,40,32,72
"405",2013,1816,1144,43,31,74
"406",2022,1855,1144,52,70,122
"407",1851,1613,6319,241,234,475
"408",1116,1002,1100,51,52,103
"409",1106,952,1100,41,42,83
"410",1516,1126,1140,73,66,139
"411",1440,1053,1140,42,33,75
"412",1914,1612,1102,96,92,188
"413",1810,1600,4489,107,113,220
"414",1708,1452,4489,45,45,90
"415",1703,1446,4489,40,39,79
"416",1707,1452,4489,44,45,89
"417",1655,1450,4489,32,43,75
"418",1807,1613,1131,102,103,205
"419",1713,1510,1131,48,40,88
"420",1730,1532,1131,65,62,127
"421",2244,2015,1132,50,55,105
"422",2228,1959,1132,34,39,73
"423",1138,1013,1134,73,71,144
"424",1137,1021,1134,72,79,151
"425",1128,1008,1134,68,66,134
"426",1219,1057,1134,114,115,229
"427",1115,1001,1134,50,59,109
"428",2019,1857,1112,47,49,96
"429",1204,1030,6726,60,76,136
"430",1200,1028,6726,55,73,128
"431",1143,1016,6726,38,61,99
"432",2120,2002,6353,39,64,103
"433",2342,2011,7037,38,58,96
"434",2,2019,7037,58,66,124
"435",2332,1951,7037,34,44,78
"436",2344,1944,7037,40,31,71
"437",1327,1105,104,123,134,257
"438",2011,1739,108,126,126,252
"439",1333,1217,367,34,53,87
"440",1840,1451,552,35,34,69
"441",2201,1855,1944,67,85,152
"442",2249,1928,1944,120,118,238
"443",2245,2054,587,157,174,331
"444",1422,1115,1015,47,60,107
"445",1408,1051,1015,33,36,69
"446",2129,1808,1944,40,38,78
"447",852,653,270,57,53,110
"448",1736,1415,1697,126,125,251
"449",1612,1302,1992,47,57,104
"450",2142,1832,1944,53,62,115
"451",2017,1903,1266,47,48,95
"452",2053,2005,2430,43,40,83
"453",1553,1419,1454,38,49,87
"454",1659,1613,473,44,48,92
"455",2028,1940,2127,33,35,68
"456",1712,1612,2378,42,42,84
"457",2034,1726,35,44,51,95
"458",1715,1614,392,45,44,89
"459",1752,1653,1046,42,43,85
"460",2131,2034,1300,111,114,225
"461",1943,1831,2597,43,51,94
"462",2151,1951,1708,61,56,117
"463",1909,1745,664,34,40,74
"464",1551,1503,2343,101,98,199
"465",832,752,3125,32,37,69
"466",2249,2155,3381,49,45,94
"467",2042,1947,329,42,47,89
"468",1458,1402,389,33,32,65
"469",1741,1620,3276,41,55,96
"470",2301,2126,53,36,31,67
"471",32,2335,117,127,130,257
"472",2233,2138,2782,58,63,121
"473",2123,2021,1815,48,56,104
"474",928,731,2830,48,36,84
"475",8,2114,6,63,74,137
"476",1039,946,291,54,61,115
"477",1729,1541,198,34,41,75
"478",2147,2003,3209,37,48,85
"479",2157,2109,107,42,49,91
"480",1648,1555,361,43,45,88
"481",2218,2039,3104,53,69,122
"482",2007,1711,35,37,36,73
"483",45,2155,1291,55,55,110
"484",2337,2220,2380,152,155,307
"485",1502,1356,843,37,46,83
"486",2216,2059,218,41,54,95
"487",2132,2000,485,37,50,87
"488",1855,1809,255,35,39,74
"489",1937,1812,39,42,47,89
"490",2258,2205,55,38,45,83
"491",2235,2142,969,45,52,97
"492",2205,2103,2372,50,58,108
"493",2302,2112,108,92,87,179
"494",1657,1502,267,42,32,74
"495",6,2115,49,56,70,126
"496",1826,1511,322,41,36,77
"497",1559,1504,500,44,49,93
"498",2202,2113,3659,57,68,125
"499",2337,2135,165,42,60,102
"500",1846,1737,296,86,97,183
"501",1921,1811,1123,36,46,82
"502",1620,1533,491,35,43,78
"503",1919,1830,591,49,55,104
"504",2203,2118,773,38,48,86
"505",2114,1930,1062,39,50,89
"506",107,2227,1086,132,142,274
"507",2216,2059,1197,61,64,125
"508",2016,1857,2127,41,37,78
"509",1905,1818,386,45,43,88
"510",2233,2149,490,48,49,97
"511",2215,2057,218,40,52,92
"512",2221,2113,51,66,48,114
"513",1951,1858,48,51,58,109
"514",1839,1723,814,79,98,177
"515",1925,1819,936,50,44,94
"516",2323,2229,969,93,99,192
"517",2204,2101,2372,49,56,105
"518",2122,1953,310,57,53,110
"519",2236,2051,108,66,66,132
"520",25,2134,49,75,89,164
"521",2207,1944,119,47,49,96
"522",2350,2139,717,40,54,94
"523",2334,2109,165,39,34,73
"524",1927,1814,1123,42,49,91
"525",2241,2025,514,86,65,151
"526",1619,1526,491,34,36,70
"527",1912,1809,591,42,34,76
"528",2218,2106,773,53,36,89
"529",2005,1711,605,45,46,91
"530",2340,2058,1086,45,53,98
"531",2202,2048,1197,47,53,100
"532",1656,1541,3654,31,41,72
"533",1439,1136,1512,52,46,98
"534",2214,1919,54,60,66,126
"535",1658,1420,1204,69,91,160
"536",1559,1302,1512,132,132,264
"537",1520,1213,1512,93,83,176
"538",2304,2025,5003,445,465,910
"539",1629,1324,5003,50,44,94
"540",1628,1349,5003,49,69,118
"541",1621,1334,5003,42,54,96
"542",2050,1742,5003,311,302,613
"543",1827,1509,5003,168,149,317
"544",1627,1339,5003,48,59,107
"545",1615,1325,5003,36,45,81
"546",1635,1321,5003,56,41,97
"547",1654,1405,5003,75,85,160
"548",2056,1722,5214,136,147,283
"549",2131,1744,5214,171,169,340
"550",2316,1930,5214,276,275,551
"551",1931,1556,5214,51,61,112
"552",2153,1919,5493,64,91,155
"553",2128,2004,147,53,54,107
"554",1834,1704,376,84,75,159
"555",1803,1635,376,53,46,99
"556",1804,1646,376,54,57,111
"557",833,712,143,57,57,114
"558",1802,1642,376,52,53,105
"559",1046,759,290,101,114,215
"560",2057,1812,292,43,50,93
"561",2220,1938,296,45,56,101
"562",2055,1800,292,37,33,70
"563",2052,1804,292,32,35,67
"564",2215,1934,296,40,46,86
"565",2121,1815,292,61,46,107
"566",1625,1331,286,44,41,85
"567",2207,1919,296,32,31,63
"568",2121,1831,292,61,62,123
"569",2017,1905,2870,42,40,82
"570",2024,1918,2870,49,53,102
"571",1205,1101,2958,45,46,91
"572",1222,1110,2958,62,55,117
"573",1059,952,3210,69,72,141
"574",1413,1310,3216,53,60,113
"575",1430,1327,3216,70,77,147
"576",1524,1418,3216,124,128,252
"577",1035,914,3265,205,194,399
"578",2152,2049,3328,62,69,131
"579",2141,2041,3328,51,61,112
"580",2148,2049,3328,58,69,127
"581",1652,1550,3390,47,55,102
"582",1644,1536,3390,39,41,80
"583",1651,1545,3390,46,50,96
"584",1655,1548,3390,50,53,103
"585",2302,2035,3717,97,105,202
"586",2220,1933,3717,55,43,98
"587",2330,2038,3717,125,108,233
"588",2324,2103,3717,119,133,252
"589",2204,1926,3717,39,36,75
"590",1841,1625,3786,41,60,101
"591",2248,1833,3786,288,188,476
"592",1842,1605,3786,42,40,82
"593",1934,1639,3786,94,74,168
"594",1908,1623,3786,68,58,126
"595",1831,1608,3786,31,43,74
"596",1839,1615,3786,39,50,89
"597",2058,1835,3786,178,190,368
"598",1411,1154,3796,31,49,80
"599",1733,1505,3796,233,240,473
"600",1607,1326,3796,147,141,288
"601",1423,1145,3796,43,40,83
"602",1415,1148,3796,35,43,78
"603",1459,1239,3796,79,94,173
"604",1051,730,3859,91,45,136
"605",1920,1829,257,60,54,114
"606",1017,937,979,42,47,89
"607",1649,1504,1174,34,34,68
"608",1915,1821,563,55,51,106
"609",1756,1705,42,31,35,66
"610",1937,1837,46,72,67,139
"611",2132,2036,56,37,36,73
"612",1940,1833,1118,65,58,123
"613",2356,2036,2012,46,41,87
"614",1907,1814,1016,32,39,71
"615",2101,1923,1161,66,53,119
"616",2149,1945,702,54,35,89
"617",1948,1815,1860,48,40,88
"618",1637,1411,3341,37,36,73
"619",2022,1924,43,52,54,106
"620",2120,1934,777,95,79,174
"621",1935,1842,1956,65,67,132
"622",1644,1555,2697,44,50,94
"623",1934,1810,1003,64,55,119
"624",1252,1118,530,47,43,90
"625",1234,1059,181,54,44,98
"626",1148,856,201,48,61,109
"627",1822,1531,748,32,51,83
"628",2125,1848,736,40,33,73
"629",2055,1900,1795,40,40,80
"630",2247,2201,51,92,96,188
"631",1743,1639,34,133,129,262
"632",1711,1616,36,71,76,147
"633",2103,2009,52,63,69,132
"634",2123,1959,1599,33,44,77
"635",1925,1832,996,100,107,207
"636",2145,2007,702,50,57,107
"637",2221,2003,1434,56,58,114
"638",2206,2009,1082,81,79,160
"639",2016,1933,38,61,63,124
"640",1725,1648,1024,65,78,143
"641",2008,1851,141,58,71,129
"642",2037,1707,1593,97,117,214
"643",2004,1909,1300,44,39,83
"644",1651,1604,1951,36,39,75
"645",1956,1902,63,86,92,178
"646",2109,2017,1981,44,47,91
"647",1700,1609,2196,60,69,129
"648",2015,1925,2934,45,55,100
"649",1951,1834,109,46,64,110
"650",1743,1620,670,43,55,98
"651",1754,1657,2378,84,87,171
"652",2008,1850,1505,73,85,158
"653",1848,1706,2001,58,61,119
"654",2113,2017,639,43,47,90
"655",2009,1753,2413,54,58,112
"656",1853,1739,2749,63,69,132
"657",1756,1342,2914,196,192,388
"658",1733,1543,2091,83,88,171
"659",1237,1134,2413,42,54,96
"660",2223,2138,480,68,68,136
"661",1608,1437,23,53,72,125
"662",2108,1932,919,33,42,75
"663",2150,2101,51,35,36,71
"664",1809,1722,3056,89,92,181
"665",1351,1259,24,51,59,110
"666",1603,1506,34,33,36,69
"667",2017,1922,44,137,142,279
"668",2239,2141,60,44,41,85
"669",2115,1859,2836,75,34,109
"670",1329,1158,15,34,33,67
"671",1951,1851,1276,76,76,152
"672",1446,1137,11,31,37,68
"673",2344,2043,47,54,68,122
"674",117,22,55,167,172,339
"675",1909,1811,386,34,36,70
"676",1957,1858,584,37,38,75
"677",1524,1423,1179,44,43,87
"678",1037,933,1502,57,58,115
"679",2114,1954,3569,39,44,83
"680",1744,1603,873,39,53,92
"681",2232,2033,2771,77,68,145
"682",1955,1654,360,55,64,119
"683",2308,2045,1016,43,50,93
"684",1648,1444,3348,163,189,352
"685",1626,1521,291,51,51,102
"686",2145,2049,867,40,44,84
"687",2028,1925,3681,68,65,133
"688",2333,2102,3772,93,82,175
"689",1843,1726,504,78,81,159
"690",2236,2049,455,141,154,295
"691",2133,2006,303,68,76,144
"692",1949,1856,922,79,81,160
"693",1256,1117,9,36,52,88
"694",2141,1958,628,31,43,74
"695",2001,1714,35,31,39,70
"696",2333,2048,3509,38,43,81
"697",1639,1517,651,49,52,101
"698",2117,1951,1233,52,51,103
"699",2031,1835,726,146,105,251
"700",1237,1105,5,92,90,182
"701",1358,1216,680,33,41,74
"702",2134,2005,919,59,75,134
"703",1936,1847,563,66,67,133
"704",1056,1001,12,56,61,117
"705",1615,1515,34,45,45,90
"706",1901,1805,46,31,35,66
"707",2222,2131,56,87,91,178
"708",1338,1212,15,43,47,90
"709",1941,1816,39,46,51,97
"710",1922,1819,1276,47,44,91
"711",2152,2047,2378,42,42,84
"712",1732,1557,869,77,72,149
"713",1751,1604,2653,46,54,100
"714",2147,2010,2771,32,45,77
"715",39,2135,49,89,90,179
"716",2223,2131,542,78,86,164
"717",1311,1221,2610,36,46,82
"718",1355,1134,1099,55,54,109
"719",2056,1928,303,31,38,69
"720",1300,1115,9,40,50,90
"721",1800,1607,2765,35,42,77
"722",2253,2112,3488,103,117,220
"723",1546,1251,2761,46,46,92
"724",2333,2046,3509,38,41,79
"725",1634,1517,709,44,52,96
"726",1857,1813,791,37,38,75
"727",2154,2115,3665,39,45,84
"728",2258,2136,3925,78,91,169
"729",1740,1355,856,55,60,115
"730",1910,1815,46,40,45,85
"731",2005,1912,50,35,42,77
"732",2157,2108,56,62,68,130
"733",1429,1246,15,94,81,175
"734",1946,1823,39,51,58,109
"735",1526,1433,2665,66,78,144
"736",56,2145,47,126,130,256
"737",1658,1558,29,48,48,96
"738",2113,2009,386,158,154,312
"739",2005,1908,584,45,48,93
"740",1448,1307,136,38,52,90
"741",2311,2128,2771,116,123,239
"742",1640,1341,19,60,71,131
"743",2337,2248,2811,152,158,310
"744",1802,1604,2765,37,39,76
"745",2157,2001,3488,47,46,93
"746",2345,2057,3509,50,52,102
"747",2344,2005,45,54,65,119
"748",1911,1815,1276,36,40,76
"749",2145,2038,2378,35,33,68
"750",2317,2155,2771,122,150,272
"751",2238,2127,3097,33,42,75
"752",2036,1900,2836,36,35,71
"753",1929,1803,39,34,38,72
"754",2159,1930,789,74,80,154
"755",2307,2041,1016,42,46,88
"756",1528,1424,848,38,34,72
"757",2108,1926,455,53,71,124
"758",2137,2043,2811,32,33,65
"759",1343,1148,9,83,83,166
"760",1627,1502,709,37,37,74
"761",2300,2124,919,145,154,299
"762",1744,1653,3056,64,63,127
"763",1731,1639,38,61,69,130
"764",2034,1935,52,34,35,69
"765",2200,2030,2836,120,125,245
"766",2336,2030,47,46,55,101
"767",1746,1522,27,41,47,88
"768",2130,1909,789,45,59,104
"769",2035,1937,3681,75,77,152
"770",2156,2008,3488,46,53,99
"771",2146,2052,1250,51,52,103
"772",2204,2105,1173,99,100,199
"773",1858,1812,791,38,37,75
"774",2346,2037,47,56,62,118
"775",1508,1402,464,33,32,65
"776",1330,1228,625,40,53,93
"777",1606,1510,291,31,40,71
"778",2057,1937,1233,32,37,69
"779",1634,1549,471,64,69,133
"780",2201,2117,3665,46,47,93
"781",2127,1940,919,52,50,102
"782",2346,1946,45,56,46,102
"783",2201,2112,51,46,47,93
"784",1909,1809,46,39,39,78
"785",2014,1912,48,74,72,146
"786",2006,1903,50,36,33,69
"787",2209,2109,52,129,129,258
"788",2228,2134,60,33,34,67
"789",1631,1453,712,66,58,124
"790",2037,1857,2836,37,32,69
"791",1952,1858,584,32,38,70
"792",2215,2105,2378,65,60,125
"793",1930,1759,2653,145,169,314
"794",1951,1857,3681,31,37,68
"795",2250,2029,3772,50,49,99
"796",2312,1900,41,62,55,117
"797",2052,1901,455,37,46,83
"798",2107,1938,1233,42,38,80
"799",1915,1830,791,55,55,110
"800",2326,2247,3665,131,137,268
"801",1721,1329,856,36,34,70
"802",1249,1157,20,49,57,106
"803",1733,1636,40,33,36,69
"804",1932,1835,48,32,35,67
"805",2250,2159,60,55,59,114
"806",2034,1856,2836,34,31,65
"807",1944,1849,1276,69,74,143
"808",2322,2007,47,32,32,64
"809",1657,1548,29,47,38,85
"810",2009,1910,584,49,50,99
"811",1647,1543,1179,127,123,250
"812",1248,1154,446,78,84,162
"813",933,831,924,73,71,144
"814",2324,2204,3097,79,79,158
"815",2359,1944,41,109,99,208
"816",2052,1907,455,37,52,89
"817",2058,1937,303,33,47,80
"818",2208,2012,3488,58,57,115
"819",2158,2115,3665,43,45,88
"820",1821,1721,42,51,51,102
"821",2326,2231,542,141,146,287
"822",2232,2047,3488,82,92,174
"823",2206,2123,3665,51,53,104
"824",2125,1943,919,50,53,103
"825",2328,1956,45,38,56,94
"826",1714,1608,38,44,38,82
"827",1909,1815,46,39,45,84
"828",1931,1836,48,31,36,67
"829",2041,1948,52,41,48,89
"830",1947,1843,1276,72,68,140
"831",1454,1148,11,39,48,87
"832",1531,1424,1179,51,44,95
"833",1534,1246,2459,64,71,135
"834",1618,1518,291,43,48,91
"835",1403,1302,2610,88,87,175
"836",2058,1954,303,33,64,97
"837",1236,1130,3192,46,75,121
"838",1903,1813,922,33,38,71
"839",2106,1929,919,31,39,70
"840",2159,2113,51,44,48,92
"841",1551,1446,32,51,46,97
"842",1633,1542,36,33,42,75
"843",1744,1648,38,74,78,152
"844",1847,1751,44,47,51,98
"845",1930,1831,46,60,61,121
"846",2124,2022,52,84,82,166
"847",1956,1901,584,36,41,77
"848",1048,940,1502,68,65,133
"849",1327,1232,2610,52,57,109
"850",2231,2015,3772,31,35,66
"851",2300,2143,3097,55,58,113
"852",1856,1707,125,41,52,93
"853",2110,1921,455,55,66,121
"854",2137,2015,2585,57,55,112
"855",1734,1635,634,39,35,74
"856",1444,1339,2229,49,39,88
"857",1703,1506,2344,38,36,74
"858",2150,2059,51,35,34,69
"859",1856,1817,791,36,42,78
"860",2255,2137,3925,75,92,167
"861",1728,1358,856,43,63,106
"862",1903,1812,563,33,32,65
"863",2137,2042,56,42,42,84
"864",1300,1150,671,40,60,100
"865",1647,1549,29,37,39,76
"866",1026,929,1249,66,69,135
"867",1439,1238,1099,99,118,217
"868",2012,1922,922,102,107,209
"869",1010,918,2805,70,73,143
"870",2157,2044,1233,92,104,196
"871",1531,1440,195,36,35,71
"872",2254,2200,60,59,60,119
"873",1446,1132,11,31,32,63
"874",2041,1943,584,81,83,164
"875",1539,1442,1179,59,62,121
"876",2241,2130,3097,36,45,81
"877",2048,1903,455,33,48,81
"878",1306,1158,2413,71,78,149
"879",2234,2153,3665,79,83,162
"880",1311,915,1628,86,80,166
"881",1700,1604,32,120,124,244
"882",2131,2043,56,36,43,79
"883",2046,1923,2836,46,58,104
"884",1943,1825,39,48,60,108
"885",1952,1857,584,32,37,69
"886",2028,1813,27,203,218,421
"887",2107,2013,3681,107,113,220
"888",2302,2151,3097,57,66,123
"889",1910,1821,922,40,46,86
"890",2204,2016,3488,54,61,115
"891",2137,2017,1233,72,77,149
"892",14,2329,3665,179,179,358
"893",2304,2140,3925,84,95,179
"894",2118,1929,919,43,39,82
"895",1558,1506,28,118,126,244
"896",1808,1659,36,128,119,247
"897",1813,1719,38,103,109,212
"898",2013,1917,48,73,77,150
"899",2046,1917,2836,46,52,98
"900",1359,1250,625,69,75,144
"901",2138,2018,816,158,163,321
"902",1446,1225,2181,36,50,86
"903",1344,1148,1099,44,68,112
"904",2341,1902,41,91,57,148
"905",2141,1953,455,86,98,184
"906",2047,1953,922,137,138,275
"907",2153,2106,2811,48,56,104
"908",2142,1950,3488,32,35,67
"909",2004,1715,35,34,40,74
"910",2358,2124,3509,63,79,142
"911",2058,1938,1233,33,38,71
"912",2148,2109,3665,33,39,72
"913",2212,2046,3925,32,41,73
"914",103,2118,45,133,138,271
"915",1527,1439,195,32,34,66
"916",1941,1855,563,71,75,146
"917",1531,1433,32,31,33,64
"918",1643,1548,34,73,78,151
"919",1716,1618,36,76,78,154
"920",1831,1729,38,121,119,240
"921",1753,1656,40,53,56,109
"922",1818,1724,42,48,54,102
"923",1849,1748,44,49,48,97
"924",2207,2113,56,72,73,145
"925",2108,1953,2836,68,88,156
"926",2028,1901,39,93,96,189
"927",1935,1817,1276,60,42,102
"928",21,2119,47,91,104,195
"929",2043,1923,816,103,108,211
"930",1645,1345,19,65,75,140
"931",1938,1632,496,38,42,80
"932",1737,1517,27,32,42,74
"933",2123,1859,789,38,49,87
"934",2345,2125,1016,80,90,170
"935",2336,1930,41,86,85,171
"936",1925,1833,2583,60,63,123
"937",1837,1726,726,32,36,68
"938",1411,1320,24,71,80,151
"939",2150,2056,867,45,51,96
"940",2309,1903,41,59,58,117
"941",2122,1959,1233,57,59,116
"942",1757,1710,3056,77,80,157
"943",1514,1408,2665,54,53,107
"944",2149,2049,2378,39,44,83
"945",1428,1258,752,33,33,66
"946",1501,1317,136,51,62,113
"947",2004,1707,496,64,77,141
"948",2155,2057,542,50,52,102
"949",2058,2002,3681,98,102,200
"950",2322,2051,3772,82,71,153
"951",1827,1716,504,62,71,133
"952",2056,1936,303,31,46,77
"953",1715,1340,2105,50,45,95
"954",1959,1706,2122,81,76,157
"955",2115,1815,2318,47,45,92
"956",1416,1243,2522,48,58,106
"957",1827,1537,2599,116,107,223
"958",1646,1345,2629,35,35,70
"959",1815,1643,2695,46,48,94
"960",2102,1912,2873,32,32,64
"961",2023,1836,2882,63,66,129
"962",2056,1925,3101,42,45,87
"963",2339,2052,3137,41,52,93
"964",2005,1706,2008,45,44,89
"965",2119,1801,2044,33,31,64
"966",11,2023,2050,97,84,181
"967",1434,1328,2223,43,38,81
"968",1812,1606,2278,34,36,70
"969",2127,1942,2280,51,32,83
"970",1710,1356,2295,80,87,167
"971",1528,1425,2399,72,70,142
"972",2015,1908,2425,61,68,129
"973",2033,1834,2598,50,49,99
"974",2051,1932,2675,136,122,258
"975",1814,1700,2784,33,35,68
"976",2108,1912,2873,38,32,70
"977",2054,1851,2882,94,81,175
"978",2019,1741,2948,123,116,239
"979",2149,2026,2954,49,46,95
"980",1329,1203,2082,53,38,91
"981",2114,2000,2804,31,40,71
"982",1126,931,2056,77,77,154
"983",1521,1428,2769,38,43,81
"984",310,226,2956,204,206,410
"985",1500,1111,3008,60,56,116
"986",2133,2027,3105,50,67,117
"987",1234,1138,3138,48,53,101
"988",18,2128,2008,298,306,604
"989",2217,2054,2042,68,84,152
"990",101,2130,2050,147,151,298
"991",2323,2234,2131,64,74,138
"992",1832,1701,2204,154,146,300
"993",2224,2009,2511,85,79,164
"994",50,2155,2597,142,150,292
"995",1758,1647,2625,124,122,246
"996",240,17,2771,202,185,387
"997",2340,2044,2782,47,49,96
"998",1459,1348,3120,54,58,112
"999",1143,849,2246,60,64,124
"1000",1959,1624,2492,40,34,74
"1001",2020,1719,2496,40,44,84
"1002",1127,853,2470,47,63,110
"1003",1118,944,2541,35,44,79
"1004",1829,1720,2784,48,55,103
"1005",1218,1007,2916,37,36,73
"1006",2357,2049,3036,51,54,105
"1007",1858,1741,2162,45,51,96
"1008",1328,1208,2200,33,33,66
"1009",1137,944,2302,54,46,100
"1010",1955,1845,2425,41,45,86
"1011",1717,1418,2472,34,33,67
"1012",1742,1535,2479,78,80,158
"1013",2125,1804,2488,91,88,179
"1014",1513,1351,2499,45,36,81
"1015",1627,1522,2581,66,62,128
"1016",1842,1727,2784,61,62,123
"1017",2344,2055,2822,50,65,115
"1018",1244,1132,2833,71,72,143
"1019",2054,1943,2975,46,43,89
"1020",2017,1910,3027,59,60,119
"1021",2025,1908,2062,36,35,71
"1022",1415,1253,2200,85,78,163
"1023",1755,1604,2497,42,34,76
"1024",2005,1909,2562,94,99,193
"1025",2114,1934,2873,44,54,98
"1026",2330,2045,3137,32,45,77
"1027",1209,1054,3119,40,39,79
"1028",2040,1917,2062,51,44,95
"1029",947,848,2189,46,48,94
"1030",1338,1213,2253,47,48,95
"1031",2116,1807,2488,82,91,173
"1032",1733,1428,2572,39,43,82
"1033",1200,854,2586,87,94,181
"1034",2252,2158,2666,44,48,92
"1035",1846,1710,2695,77,75,152
"1036",1309,1206,2826,38,36,74
"1037",1733,1626,2884,62,56,118
"1038",2134,2020,2954,34,40,74
"1039",46,4,2956,60,64,124
"1040",2144,2041,3022,38,51,89
"1041",2237,2040,3154,46,50,96
"1042",2018,1732,2008,58,70,128
"1043",2325,2213,2024,74,63,137
"1044",2219,2050,2042,70,80,150
"1045",2346,2045,2055,63,75,138
"1046",1504,1144,2064,100,89,189
"1047",1925,1622,2122,47,32,79
"1048",1958,1826,2212,67,36,103
"1049",2145,1832,2276,94,97,191
"1050",1333,1217,2277,40,37,77
"1051",1704,1547,2282,71,62,133
"1052",1938,1607,2298,50,32,82
"1053",1853,1533,2317,87,88,175
"1054",1819,1455,2334,61,35,96
"1055",2027,1642,2492,68,52,120
"1056",1921,1826,2562,50,56,106
"1057",1744,1603,2569,85,73,158
"1058",2131,2035,2570,63,70,133
"1059",1630,1505,2581,69,45,114
"1060",1647,1545,2631,72,65,137
"1061",2006,1855,2675,91,85,176
"1062",21,2124,2782,88,89,177
"1063",2232,2054,2938,39,44,83
"1064",2138,2017,2954,38,37,75
"1065",7,2200,2976,58,45,103
"1066",1936,1805,3005,67,35,102
"1067",2214,2053,3022,68,63,131
"1068",1219,1116,3119,45,61,106
"1069",2115,1914,3127,72,54,126
"1070",1557,1458,2769,74,73,147
"1071",2016,1706,2496,36,31,67
"1072",1059,1013,2559,31,43,74
"1073",1802,1450,2715,64,50,114
"1074",1757,1626,2748,42,31,73
"1075",1557,1447,2769,74,62,136
"1076",2349,2053,2782,56,58,114
"1077",1128,955,2792,62,55,117
"1078",1758,1646,2884,87,76,163
"1079",1609,1331,3004,41,31,72
"1080",1120,842,3083,64,57,121
"1081",2133,2005,3101,79,85,164
"1082",1455,1158,2041,85,53,138
"1083",2249,2158,2261,41,43,84
"1084",1447,1201,2270,32,31,63
"1085",1442,1337,2304,39,47,86
"1086",1145,1034,2649,61,69,130
"1087",1814,1706,2705,36,41,77
"1088",1710,1548,2778,66,67,133
"1089",1318,1215,2817,44,50,94
"1090",1831,1722,2931,36,41,77
"1091",1815,1643,2945,126,128,254
"1092",2044,1743,2008,84,81,165
"1093",1655,1556,2025,31,46,77
"1094",2330,2024,2055,47,54,101
"1095",2002,1626,2105,217,211,428
"1096",12,2103,2597,104,98,202
"1097",2025,1816,2598,42,31,73
"1098",41,2220,2771,83,68,151
"1099",1825,1516,2791,107,111,218
"1100",2150,2037,2830,80,82,162
"1101",1153,1050,3041,37,35,72
"1102",1737,1422,2333,67,57,124
"1103",2315,2154,2361,44,41,85
"1104",2127,1803,2044,41,33,74
"1105",1505,1110,3008,65,55,120
"1106",2332,2227,3022,146,157,303
"1107",38,2150,3137,100,110,210
"1108",2235,2024,2511,96,94,190
"1109",1541,1212,2520,96,82,178
"1110",1920,1751,2569,181,181,362
"1111",17,2308,2648,104,108,212
"1112",1912,1743,2840,72,68,140
"1113",1911,1623,2122,33,33,66
"1114",2037,1723,2488,43,47,90
"1115",2101,1906,2598,78,81,159
"1116",1635,1517,2625,41,32,73
"1117",1216,1030,2302,93,92,185
"1118",1716,1453,2479,52,38,90
"1119",1856,1711,2497,103,101,204
"1120",2240,2152,2666,32,42,74
"1121",1130,938,2967,60,43,103
"1122",1619,1354,3004,51,54,105
"1123",2155,2044,3022,49,54,103
"1124",1335,1205,2082,54,40,94
"1125",1347,1219,2200,52,44,96
"1126",1931,1621,2298,43,46,89
"1127",1613,1505,2304,130,135,265
"1128",1321,1234,2407,48,59,107
"1129",1418,1246,2429,75,71,146
"1130",1247,1129,2434,69,74,143
"1131",1352,1213,2576,73,73,146
"1132",1706,1617,2631,91,97,188
"1133",2015,1902,2675,100,92,192
"1134",1551,1246,2736,158,151,309
"1135",1523,1424,2769,40,39,79
"1136",1729,1422,2791,51,57,108
"1137",2102,1955,2830,32,40,72
"1138",1649,1512,2844,141,132,273
"1139",1740,1647,2884,69,77,146
"1140",1245,1031,2916,64,60,124
"1141",1709,1613,2936,38,38,76
"1142",1117,942,2967,47,47,94
"1143",1215,1057,3060,35,37,72
"1144",1418,1218,3092,45,43,88
"1145",1230,1135,3138,44,50,94
"1146",1537,1409,2048,54,49,103
"1147",34,2131,2055,111,121,232
"1148",2025,1913,2062,36,40,76
"1149",1133,932,2302,55,34,89
"1150",2117,1807,2318,49,37,86
"1151",1757,1502,2405,43,52,95
"1152",1238,936,2435,83,71,154
"1153",2245,2139,2481,132,129,261
"1154",2011,1714,2496,31,39,70
"1155",1821,1521,2550,46,61,107
"1156",1629,1530,2591,60,60,120
"1157",1543,1338,2593,39,43,82
"1158",1702,1435,2599,31,45,76
"1159",1651,1542,2625,52,52,104
"1160",1613,1526,2631,38,46,84
"1161",2316,2202,2648,43,42,85
"1162",2312,2213,2666,64,63,127
"1163",1759,1507,2715,51,57,108
"1164",2101,2012,2731,66,72,138
"1165",1547,1450,2769,64,65,129
"1166",2330,2048,2782,37,53,90
"1167",2208,2044,2800,32,39,71
"1168",2230,2136,2803,32,31,63
"1169",2043,1815,2948,147,150,297
"1170",2213,2102,2954,73,82,155
"1171",1703,1417,2980,40,52,92
"1172",2339,2034,3036,33,39,72
"1173",2200,1959,3038,41,34,75
"1174",2328,2200,2192,50,45,95
"1175",1752,1703,2442,62,63,125
"1176",2140,1938,2511,46,48,94
"1177",1858,1627,2948,47,42,89
"1178",2343,2031,2060,40,46,86
"1179",1735,1627,2069,58,63,121
"1180",2026,1727,2122,108,97,205
"1181",1446,1118,2446,37,38,75
"1182",2147,1923,2511,48,33,81
"1183",1906,1801,2562,35,31,66
"1184",2044,1851,2598,61,66,127
"1185",1730,1354,2780,34,34,68
"1186",2328,2036,2822,34,46,80
"1187",2150,1833,2044,64,63,127
"1188",1739,1417,2066,54,52,106
"1189",2339,2255,2261,91,100,191
"1190",1922,1819,2675,47,49,96
"1191",1832,1729,2705,54,64,118
"1192",2102,2016,2731,67,76,143
"1193",1632,1438,2881,122,113,235
"1194",2012,1924,2902,88,94,182
"1195",1810,1645,2920,37,40,77
"1196",2201,2016,3038,42,51,93
"1197",1912,1626,2948,56,41,97
"1198",2205,2059,3022,59,69,128
"1199",2053,1932,2417,48,32,80
"1200",1832,1739,2442,112,114,226
"1201",2121,2023,2481,48,53,101
"1202",1714,1440,2599,43,50,93
"1203",1826,1708,2944,66,73,139
"1204",1209,1019,3088,48,54,102
"1205",2347,2017,2050,77,82,159
"1206",1124,1026,2058,53,61,114
"1207",1852,1731,2162,59,61,120
"1208",1722,1600,2216,69,60,129
"1209",1454,1354,2223,63,64,127
"1210",1758,1641,2296,101,110,211
"1211",1651,1528,2304,171,161,332
"1212",1510,1419,2399,69,79,148
"1213",1326,1240,2407,53,65,118
"1214",2018,1917,2425,50,63,113
"1215",2113,2017,2481,40,47,87
"1216",2037,1717,2492,78,87,165
"1217",2157,1904,2496,132,144,276
"1218",1559,1255,2520,139,150,289
"1219",1615,1521,2581,54,61,115
"1220",1051,938,2649,46,43,89
"1221",1257,932,2678,97,95,192
"1222",1744,1611,2695,40,41,81
"1223",1824,1712,2705,41,42,83
"1224",2157,2105,2731,102,105,207
"1225",1747,1629,2773,166,161,327
"1226",1827,1715,2784,31,35,66
"1227",2213,2057,2800,37,52,89
"1228",1840,1532,2816,200,202,402
"1229",1223,1116,2833,50,56,106
"1230",2116,1933,2873,46,53,99
"1231",1859,1735,2920,66,70,136
"1232",1902,1733,2944,83,88,171
"1233",2207,2057,2954,87,97,184
"1234",1201,1028,2967,91,93,184
"1235",2210,2113,2984,56,63,119
"1236",1948,1852,3005,64,67,131
"1237",2242,2116,3016,54,71,125
"1238",2131,2026,3022,35,46,81
"1239",2151,2023,3027,188,168,356
"1240",2346,2045,3036,40,50,90
"1241",2257,2109,3038,58,64,122
"1242",958,840,3059,58,60,118
"1243",1229,1125,3119,60,75,135
"1244",2243,2101,3127,155,156,311
"1245",2026,1732,3132,43,47,90
"1246",2301,1931,2050,31,36,67
"1247",2358,2058,2060,50,68,118
"1248",43,2214,2098,49,59,108
"1249",1914,1539,2105,174,169,343
"1250",1135,1046,2132,74,86,160
"1251",2329,2005,2171,34,50,84
"1252",2154,2013,2376,120,123,243
"1253",1052,950,2453,33,40,73
"1254",2156,2103,2481,83,93,176
"1255",2032,1709,2488,38,33,71
"1256",1415,1115,2520,40,50,90
"1257",2325,2032,2630,42,67,109
"1258",1843,1716,2695,99,106,205
"1259",2351,2210,2752,42,55,97
"1260",1658,1543,2778,40,48,88
"1261",1650,1457,2793,71,72,143
"1262",2114,2012,2830,34,47,81
"1263",1900,1754,2834,39,39,78
"1264",1359,1220,2871,44,45,89
"1265",1703,1606,2884,32,36,68
"1266",2339,2256,2907,193,211,404
"1267",37,2115,2922,59,70,129
"1268",1951,1758,2945,230,211,441
"1269",1838,1702,2952,150,137,287
"1270",1137,806,3006,33,46,79
"1271",1330,1218,3054,54,53,107
"1272",1445,1131,2039,36,36,72
"1273",1840,1717,2162,52,47,99
"1274",1049,1002,2210,44,47,91
"1275",1844,1713,2346,51,58,109
"1276",2038,1927,2425,75,73,148
"1277",2329,2223,2515,64,63,127
"1278",1840,1711,2569,137,132,269
"1279",1830,1518,2572,96,88,184
"1280",1431,1125,2622,62,60,122
"1281",1941,1807,2748,77,57,134
"1282",1544,1425,2773,48,37,85
"1283",1649,1523,2945,53,56,109
"1284",1935,1831,2955,64,61,125
"1285",2037,1929,3005,118,104,222
"1286",1221,1118,3041,60,58,118
"1287",1728,1642,3053,40,57,97
"1288",1103,849,3083,52,64,116
"1289",1614,1516,428,64,76,140
"1290",1850,1741,458,60,66,126
"1291",1045,932,493,35,37,72
"1292",2233,2143,533,73,98,171
"1293",2300,2140,533,100,95,195
"1294",2228,2111,653,58,51,109
"1295",2224,2120,653,54,60,114
"1296",2208,2108,653,38,48,86
"1297",1936,1813,1121,111,103,214
"1298",1823,1708,1121,38,38,76
"1299",1029,912,1225,129,122,251
"1300",2353,2049,1294,158,174,332
"1301",1657,1517,1298,92,62,154
"1302",1156,1036,1436,91,86,177
"1303",1056,952,1436,31,42,73
"1304",1422,1302,1505,57,52,109
"1305",1357,1259,1820,47,54,101
"1306",1406,1304,1820,56,59,115
"1307",1351,1250,1820,41,45,86
"1308",1029,708,1994,74,68,142
"1309",1010,707,1994,55,67,122
"1310",1453,1135,2137,83,85,168
"1311",1406,1056,2137,36,46,82
"1312",2143,1903,731,33,38,71
"1313",13,2117,731,183,172,355
"1314",2341,1938,624,221,243,464
"1315",1235,809,620,78,69,147
"1316",2200,1742,624,120,127,247
"1317",2207,1653,624,127,78,205
"1318",1517,1107,620,240,247,487
"1319",2314,1824,624,194,169,363
"1320",2145,1710,624,105,95,200
"1321",1517,1040,1,87,75,162
"1322",1732,1600,137,92,105,197
"1323",29,2252,150,106,112,218
"1324",11,2058,190,96,108,204
"1325",1514,1038,232,77,83,160
"1326",1303,942,309,95,47,142
"1327",44,2036,310,71,96,167
"1328",1336,927,332,83,107,190
"1329",2124,2018,423,60,63,123
"1330",1821,1348,432,183,193,376
"1331",1729,1342,458,41,47,88
"1332",26,2136,467,44,31,75
"1333",2005,1540,532,130,135,265
"1334",2237,1933,567,50,33,83
"1335",1555,1417,601,75,70,145
"1336",2253,1839,632,156,174,330
"1337",2226,2022,670,52,77,129
"1338",17,1958,732,59,68,127
"1339",2340,2031,755,63,61,124
"1340",1803,1515,767,48,40,88
"1341",2059,2008,1441,48,53,101
"1342",1615,1209,1476,100,109,209
"1343",21,2048,1488,75,93,168
"1344",1830,1532,1562,72,87,159
"1345",1749,1611,1589,105,96,201
"1346",2349,1923,1632,104,108,212
"1347",2054,1643,1676,34,38,72
"1348",1053,822,1746,48,57,105
"1349",1830,1405,1836,98,90,188
"1350",2200,1924,1889,105,84,189
"1351",1747,1149,212,87,94,181
"1352",1239,1014,309,80,84,164
"1353",2110,1945,417,42,50,92
"1354",2326,2022,444,108,82,190
"1355",2139,1816,558,98,131,229
"1356",1704,1556,623,80,81,161
"1357",40,2220,1046,53,65,118
"1358",1431,1220,1620,60,45,105
"1359",2044,1658,1688,50,58,108
"1360",2126,1932,1689,90,69,159
"1361",107,2307,1758,98,112,210
"1362",1800,1406,1832,118,151,269
"1363",2003,1841,59,35,48,83
"1364",1402,1303,279,49,45,94
"1365",2307,2143,299,47,48,95
"1366",1627,1201,382,47,61,108
"1367",2249,2040,444,76,100,176
"1368",1845,1420,532,48,55,103
"1369",1722,1443,546,172,178,350
"1370",1822,1646,795,47,56,103
"1371",2314,1923,1010,52,88,140
"1372",2218,2105,1441,98,76,174
"1373",2327,2045,1506,95,115,210
"1374",1430,1059,1544,38,44,82
"1375",1721,1423,1548,34,53,87
"1376",1606,1424,1620,155,169,324
"1377",2022,1837,1795,54,51,105
"1378",1720,1618,33,31,38,69
"1379",2025,1607,62,75,92,167
"1380",1708,1418,206,59,73,132
"1381",55,2222,209,57,57,114
"1382",1708,1117,212,46,62,108
"1383",1531,1106,232,94,111,205
"1384",2212,1842,244,162,177,339
"1385",1432,1206,270,48,41,89
"1386",2000,1833,275,162,170,332
"1387",1806,1650,297,56,65,121
"1388",1340,1119,343,117,99,216
"1389",1708,1312,409,78,75,153
"1390",2139,1743,412,51,48,99
"1391",2107,2007,423,43,52,95
"1392",1,2017,426,34,67,101
"1393",1602,1123,432,44,48,92
"1394",2004,1535,532,129,130,259
"1395",1454,1107,544,264,262,526
"1396",2230,2012,570,130,142,272
"1397",14,1922,582,37,32,69
"1398",2323,1916,632,186,211,397
"1399",2350,2033,644,79,103,182
"1400",2204,1918,667,117,113,230
"1401",2221,2004,670,47,59,106
"1402",2247,1809,682,110,118,228
"1403",37,2040,732,79,110,189
"1404",1425,1254,738,36,34,70
"1405",1819,1550,746,81,90,171
"1406",1304,859,776,87,99,186
"1407",1925,1655,1070,55,55,110
"1408",2154,1855,1086,153,175,328
"1409",2311,2121,1095,44,31,75
"1410",6,2041,1417,60,91,151
"1411",2235,2148,1441,144,153,297
"1412",1543,1142,1476,68,82,150
"1413",2356,2306,1479,106,116,222
"1414",2231,2137,1533,31,32,63
"1415",1456,1118,1544,42,48,90
"1416",1808,1506,1548,76,96,172
"1417",1759,1437,1562,41,32,73
"1418",1945,1900,1603,55,65,120
"1419",1515,1328,1620,95,108,203
"1420",1717,1612,1621,90,102,192
"1421",14,2000,1632,129,145,274
"1422",1326,1100,1646,31,40,71
"1423",2154,1754,1676,94,109,203
"1424",1645,1451,1695,105,96,201
"1425",1808,1708,1787,59,73,132
"1426",1707,1409,1790,31,54,85
"1427",1735,1257,1832,88,82,170
"1428",2109,1859,1858,67,79,146
"1429",2003,1830,59,48,50,98
"1430",1651,1459,137,51,44,95
"1431",11,1951,310,38,51,89
"1432",2307,2046,444,89,106,195
"1433",2142,1836,570,82,46,128
"1434",2124,1810,667,77,45,122
"1435",2309,2042,670,95,97,192
"1436",22,2147,770,72,47,119
"1437",143,2139,1466,34,44,78
"1438",2303,1951,1648,216,231,447
"1439",1950,1820,59,35,40,75
"1440",1745,1526,146,125,141,266
"1441",2109,1920,1795,101,94,195
"1442",2059,1856,1889,44,56,100
"1443",1705,1529,137,60,69,129
"1444",1653,1108,212,31,53,84
"1445",1449,1113,226,34,58,92
"1446",1323,1218,279,32,33,65
"1447",1053,955,1679,31,35,66
"1448",2031,1636,1688,37,36,73
"1449",2305,2116,47,114,108,222
"1450",1634,1447,137,34,32,66
"1451",1913,1635,146,213,210,423
"1452",1602,1156,232,125,161,286
"1453",1957,1700,246,82,65,147
"1454",1200,930,346,35,45,80
"1455",2002,1851,397,37,51,88
"1456",2309,2036,444,91,96,187
"1457",2233,1956,567,46,56,102
"1458",2329,2011,616,82,56,138
"1459",2331,2000,658,37,61,98
"1460",1929,1647,746,151,147,298
"1461",1737,1436,786,52,66,118
"1462",2300,1950,1027,34,50,84
"1463",1245,1034,1407,70,79,149
"1464",1558,1310,1646,183,170,353
"1465",1750,1328,1832,103,113,216
"1466",2232,1818,210,124,148,272
"1467",2015,1708,246,100,73,173
"1468",1307,1137,403,52,52,104
"1469",2338,2108,444,120,128,248
"1470",1441,1302,499,86,72,158
"1471",1502,1220,546,32,35,67
"1472",2243,2022,567,56,82,138
"1473",2057,1841,570,37,51,88
"1474",1742,1455,746,44,35,79
"1475",1054,927,799,39,42,81
"1476",1853,1456,810,75,106,181
"1477",1422,1149,1646,92,89,181
"1478",2242,2046,1795,194,180,374
"1479",2325,2148,150,47,48,95
"1480",1412,1156,270,33,31,64
"1481",1153,1032,739,78,87,165
"1482",1958,1730,767,166,175,341
"1483",2255,2158,1423,44,48,92
"1484",1627,1517,1621,45,47,92
"1485",1502,1313,1882,103,103,206
"1486",1356,1249,197,33,54,87
"1487",1819,1218,212,117,123,240
"1488",1749,1541,370,64,76,140
"1489",2137,2003,417,69,68,137
"1490",2146,1845,570,86,55,141
"1491",2243,2002,670,69,57,126
"1492",1816,1409,810,38,59,97
"1493",2008,1737,1070,98,97,195
"1494",2152,2016,47,59,66,125
"1495",1036,840,52,62,55,117
"1496",2032,1900,59,77,80,157
"1497",1442,1212,270,58,47,105
"1498",1956,1723,370,191,178,369
"1499",2217,1927,570,117,97,214
"1500",1815,1623,663,287,288,575
"1501",27,2135,670,173,150,323
"1502",1542,1225,686,112,115,227
"1503",30,2212,770,80,72,152
"1504",1437,1052,788,32,37,69
"1505",1129,811,1048,36,41,77
"1506",2014,1742,1070,104,102,206
"1507",2054,1957,1441,43,42,85
"1508",2252,2031,444,53,71,124
"1509",1822,1644,795,54,64,118
"1510",1738,1637,1079,111,112,223
"1511",2342,1955,1488,31,35,66
"1512",2254,1935,1586,42,40,82
"1513",1729,1538,137,74,70,144
"1514",945,826,199,38,61,99
"1515",1828,1407,532,43,47,90
"1516",2145,1859,570,72,54,126
"1517",2130,1700,632,77,75,152
"1518",8,1937,732,63,47,110
"1519",1903,1642,1070,43,42,85
"1520",2341,1902,1632,101,79,180
"1521",30,2030,1776,62,75,137
"1522",1714,1301,1832,64,76,140
"1523",1227,949,170,68,59,127
"1524",1353,1245,197,32,50,82
"1525",1510,1244,270,80,79,159
"1526",1246,825,332,33,40,73
"1527",1820,1552,370,89,87,176
"1528",1222,1122,497,109,137,246
"1529",1843,1406,532,58,46,104
"1530",2222,1909,570,137,84,221
"1531",2124,1633,632,71,48,119
"1532",2107,1842,667,64,77,141
"1533",16,1948,732,71,58,129
"1534",128,2322,752,89,103,192
"1535",2357,2121,770,46,31,77
"1536",2315,1845,1010,55,55,110
"1537",2016,1754,1070,116,114,230
"1538",2312,2003,1506,66,63,129
"1539",2327,1852,1632,87,69,156
"1540",1711,1238,1832,61,53,114
"1541",2117,1641,62,140,136,276
"1542",2210,1717,632,117,92,209
"1543",1226,1110,756,86,115,201
"1544",1545,1435,197,144,160,304
"1545",2326,2023,500,36,58,94
"1546",1935,1734,1070,75,94,169
"1547",1008,820,1097,71,50,121
"1548",2028,1852,1511,36,52,88
"1549",1103,930,1639,55,40,95
"1550",2126,2004,1795,114,139,253
"1551",2046,1639,62,109,134,243
"1552",1405,1244,499,40,54,94
"1553",10,1955,582,37,60,97
"1554",1842,1659,663,320,334,654
"1555",1816,1425,810,41,75,116
"1556",1900,1533,1844,39,58,97
"1557",2136,1721,62,159,176,335
"1558",2017,1810,150,62,35,97
"1559",2308,2019,616,67,69,136
"1560",1754,1620,697,104,100,204
"1561",215,7,752,136,148,284
"1562",1854,1705,795,86,85,171
"1563",1913,1655,1070,53,55,108
"1564",30,2309,1095,115,139,254
"1565",1748,1640,1787,41,45,86
"1566",2330,2023,1830,35,50,85
"1567",1625,1209,106,70,84,154
"1568",1724,1520,320,53,50,103
"1569",2126,1758,410,31,55,86
"1570",1516,1349,601,36,45,81
"1571",2105,1646,632,52,61,113
"1572",2204,1927,709,81,82,163
"1573",2356,1941,732,51,51,102
"1574",1958,1820,59,46,45,91
"1575",2009,1558,62,72,93,165
"1576",1621,1155,106,66,70,136
"1577",1700,1500,137,45,32,77
"1578",7,2003,310,38,63,101
"1579",1930,1656,370,159,151,310
"1580",41,2158,467,46,43,89
"1581",2026,1609,810,171,179,350
"1582",2234,1917,1546,149,109,258
"1583",2011,1822,1795,39,37,76
"1584",1308,954,1873,40,44,84
"1585",1555,1310,267,36,35,71
"1586",1233,858,544,69,73,142
"1587",2308,2212,1423,57,67,124
"1588",1539,1228,1448,97,108,205
"1589",1502,1316,1605,38,37,75
"1590",1432,1218,1646,94,108,202
"1591",1145,909,1746,110,104,214
"1592",1307,1207,1823,88,92,180
"1593",1108,716,89,56,76,132
"1594",1652,1507,137,37,39,76
"1595",949,827,199,132,147,279
"1596",2331,2027,500,46,62,108
"1597",1721,1401,534,43,61,104
"1598",2357,2006,732,57,76,133
"1599",1212,1105,1823,38,35,73
"1600",1742,1315,1836,61,45,106
"1601",2057,1901,1858,69,86,155
"1602",2140,1907,570,95,82,177
"1603",1921,1619,606,37,39,76
"1604",2058,1813,667,55,48,103
"1605",1727,1342,744,34,32,66
"1606",2040,1638,1648,69,33,102
"1607",1952,1839,1705,58,64,122
"1608",2219,2041,1711,121,111,232
"1609",1642,1324,1757,43,34,77
"1610",1711,1613,33,37,48,85
"1611",1706,1252,60,33,47,80
"1612",1943,1531,62,46,66,112
"1613",1516,1417,323,53,62,115
"1614",1613,1510,623,36,40,76
"1615",1029,940,1583,33,40,73
"1616",1916,1812,1779,36,33,69
"1617",1138,946,220,32,41,73
"1618",1215,826,626,55,66,121
"1619",2308,2128,1095,33,38,71
"1620",2126,2043,1411,84,98,182
"1621",2311,2204,1423,60,59,119
"1622",2350,2027,1488,39,67,106
"1623",1803,1639,1497,31,39,70
"1624",1430,1014,1,40,49,89
"1625",2025,1828,150,70,53,123
"1626",1255,1109,199,228,224,452
"1627",1639,1334,206,35,34,69
"1628",1805,1426,406,133,146,279
"1629",30,2230,752,31,51,82
"1630",1136,950,756,31,35,66
"1631",2033,1939,1411,31,34,65
"1632",1224,842,1590,91,72,163
"1633",1119,943,1623,86,58,144
"1634",2008,1848,1674,62,55,117
"1635",1138,1035,1679,68,70,138
"1636",1228,1046,1723,40,36,76
"1637",1254,1124,1882,42,74,116
"1638",1500,1156,1512,73,66,139
"1639",1259,1014,1590,31,45,76
"1640",1723,1440,1900,433,460,893
"1641",2150,1904,54,36,51,87
"1642",1839,1547,1512,292,297,589
"1643",1949,1630,8,46,31,77
"1644",1111,732,1471,127,87,214
"1645",1025,745,1960,55,63,118
"1646",1608,1504,850,33,44,77
"1647",1830,1744,863,45,49,94
"1648",2029,1940,766,34,40,74
"1649",1554,1456,1132,59,56,115
"1650",1456,1401,2229,61,61,122
"1651",1311,1213,2756,46,43,89
"1652",1659,1606,2781,64,66,130
"1653",1805,1511,2688,35,51,86
"1654",1305,1138,1793,60,33,93
"1655",2106,1949,825,66,69,135
"1656",1726,1533,3004,56,63,119
"1657",1553,1506,2101,48,56,104
"1658",1716,1629,3056,36,39,75
"1659",45,2147,47,115,132,247
"1660",1235,1100,5,90,85,175
"1661",1658,1511,23,103,106,209
"1662",2127,1948,919,52,58,110
"1663",2201,2058,51,46,33,79
"1664",1338,1237,24,38,37,75
"1665",1917,1821,46,47,51,98
"1666",2126,2031,56,31,31,62
"1667",1931,1756,39,36,31,67
"1668",1518,1149,11,63,49,112
"1669",2356,2042,47,66,67,133
"1670",2301,2208,55,31,38,69
"1671",1735,1601,869,80,76,156
"1672",1750,1608,2653,45,58,103
"1673",2212,2024,2771,57,59,116
"1674",2342,2044,49,32,39,71
"1675",1817,1533,27,72,58,130
"1676",2116,1850,789,31,40,71
"1677",2302,2037,1016,37,42,79
"1678",1329,1055,3578,79,75,154
"1679",1337,1233,2610,62,58,120
"1680",2254,2024,3772,54,44,98
"1681",2203,2029,303,98,99,197
"1682",1903,1809,922,33,34,67
"1683",2159,2104,2811,54,54,108
"1684",2142,1955,3488,32,40,72
"1685",1628,1506,709,38,41,79
"1686",1605,1516,471,35,36,71
"1687",1851,1753,44,51,53,104
"1688",1649,1553,29,39,43,82
"1689",1613,1512,1179,93,92,185
"1690",1447,1248,136,37,33,70
"1691",5,2109,49,55,64,119
"1692",1622,1520,291,47,50,97
"1693",1513,1312,882,38,42,80
"1694",2114,1939,303,49,49,98
"1695",2136,2046,2811,31,36,67
"1696",1608,1524,471,38,44,82
"1697",1916,1828,791,56,53,109
"1698",2221,2136,3665,66,66,132
"1699",102,2136,45,132,156,288
"1700",1929,1837,563,59,57,116
"1701",1717,1631,3056,37,41,78
"1702",1436,1342,28,36,42,78
"1703",1533,1437,32,33,37,70
"1704",2052,1949,52,52,49,101
"1705",2131,2039,56,36,39,75
"1706",2231,2139,60,36,39,75
"1707",1922,1809,1276,47,34,81
"1708",1535,1430,1179,55,50,105
"1709",1506,1210,2459,36,35,71
"1710",1432,1305,752,37,40,77
"1711",2116,1949,3569,41,39,80
"1712",2146,2000,2771,31,35,66
"1713",1750,1532,27,45,57,102
"1714",1609,1513,291,34,43,77
"1715",1313,1210,2610,38,35,73
"1716",2001,1903,3681,41,43,84
"1717",1904,1807,922,34,32,66
"1718",2214,2122,2811,69,72,141
"1719",912,831,579,37,41,78
"1720",2034,1932,52,34,32,66
"1721",1327,1157,15,32,32,64
"1722",1911,1814,1276,36,39,75
"1723",2325,2025,47,35,50,85
"1724",2020,1924,584,60,64,124
"1725",1220,1045,3133,55,45,100
"1726",1316,1216,2610,41,41,82
"1727",2035,1944,3681,75,84,159
"1728",1350,1136,1099,50,56,106
"1729",2112,1910,455,57,55,112
"1730",1516,1323,882,41,53,94
"1731",1942,1850,922,72,75,147
"1732",1631,1536,36,31,36,67
"1733",2301,2207,55,31,37,68
"1734",1844,1726,752,289,301,590
"1735",1038,913,2969,133,133,266
"1736",2221,2134,2811,76,84,160
"1737",1453,1330,707,163,165,328
"1738",1208,1112,18,43,42,85
"1739",2015,1854,218,105,119,224
"1740",2217,2045,1796,42,45,87
"1741",1836,1741,44,36,41,77
"1742",2006,1916,48,66,76,142
"1743",2221,2127,2427,141,147,288
"1744",1625,1357,1945,145,142,287
"1745",1707,1607,2315,32,32,64
"1746",1622,1513,2839,32,33,65
"1747",1637,1411,1945,157,156,313
"1748",934,841,1628,49,56,105
"1749",1702,1610,2383,42,45,87
"1750",1231,1121,104,61,66,127
"1751",1918,1809,1270,58,64,122
"1752",2207,2047,1796,32,47,79
"1753",1417,1239,1227,57,64,121
"1754",1659,1317,2195,34,52,86
"1755",1431,1341,1938,61,61,122
"1756",1130,1035,2502,55,60,115
"1757",1112,855,1507,37,45,82
"1758",1829,1609,2018,54,64,118
"1759",2222,2131,709,37,31,68
"1760",1604,1518,1773,59,58,117
"1761",2210,2046,1796,35,46,81
"1762",2200,2116,51,40,46,86
"1763",1557,1457,32,57,57,114
"1764",1942,1847,38,197,197,394
"1765",1802,1709,40,62,69,131
"1766",1905,1809,46,40,39,79
"1767",2005,1912,50,35,42,77
"1768",2015,1844,41,50,54,104
"1769",2206,1857,264,41,47,88
"1770",1648,1548,19,198,198,396
"1771",1606,1448,2085,96,83,179
"1772",2254,1956,2907,214,226,440
"1773",1848,1755,37,43,50,93
"1774",1731,1618,2315,56,43,99
"1775",1557,1338,1921,207,213,420
"1776",1805,1645,559,40,40,80
"1777",1608,1451,2578,33,36,69
"1778",2221,1817,39,51,52,103
"1779",2104,1916,215,39,51,90
"1780",1903,1809,5016,33,34,67
"1781",1832,1636,3474,67,71,138
"1782",2026,1734,35,61,64,125
"1783",1258,1013,323,113,123,236
"1784",1153,1108,576,33,33,66
"1785",2211,2041,1796,36,41,77
"1786",1839,1736,40,99,96,195
"1787",1827,1719,42,62,49,111
"1788",1942,1845,44,102,105,207
"1789",2203,2101,50,153,151,304
"1790",2053,1959,52,58,59,117
"1791",2148,2042,56,53,42,95
"1792",1612,1518,3803,127,133,260
"1793",1416,1057,9,36,32,68
"1794",2227,1920,264,62,70,132
"1795",2033,1938,3575,33,38,71
"1796",1807,1637,2954,107,112,219
"1797",2019,1704,2907,59,54,113
"1798",2228,2018,3832,83,103,186
"1799",922,817,1628,37,32,69
"1800",1310,1042,1921,40,37,77
"1801",1302,1133,1509,32,38,70
"1802",1832,1629,3474,67,64,131
"1803",2247,1950,35,202,200,402
"1804",5,2123,3358,65,73,138
"1805",1607,1448,2094,32,38,70
"1806",2217,2056,1796,42,56,98
"1807",1430,1320,24,90,80,170
"1808",1443,1350,28,43,50,93
"1809",1602,1446,30,92,76,168
"1810",2048,1949,40,228,229,457
"1811",2008,1914,50,38,44,82
"1812",2141,2051,56,46,51,97
"1813",1821,1645,29,116,110,226
"1814",2112,1950,41,107,120,227
"1815",112,19,55,172,179,351
"1816",2103,2004,3575,63,64,127
"1817",2150,2044,1662,35,34,69
"1818",1742,1617,2085,192,172,364
"1819",2355,2055,49,40,45,85
"1820",2059,1842,2018,204,217,421
"1821",2048,1952,1590,43,47,90
"1822",2151,2058,1610,41,48,89
"1823",1342,1245,2333,67,70,137
"1824",1531,1327,2194,201,202,403
"1825",2228,2040,869,63,70,133
"1826",2102,1804,35,97,94,191
"1827",1148,852,323,43,42,85
"1828",2158,2039,1504,33,39,72
"1829",1428,1331,2649,33,31,64
"1830",2117,1906,682,42,51,93
"1831",2104,2018,1961,124,128,252
"1832",2030,1937,50,60,67,127
"1833",1724,1627,1790,44,47,91
"1834",2143,2017,2678,78,87,165
"1835",2308,2218,3428,38,43,81
"1836",1,2011,45,71,76,147
"1837",1651,1606,34,86,96,182
"1838",2023,1921,50,53,51,104
"1839",2048,1922,43,38,47,85
"1840",1821,1703,29,116,128,244
"1841",1403,1310,19,33,40,73
"1842",2254,2158,55,34,38,72
"1843",1945,1854,798,70,79,149
"1844",1723,1621,1790,43,41,84
"1845",1036,936,3,36,41,77
"1846",1854,1640,2018,79,95,174
"1847",2254,2044,3720,34,54,88
"1848",830,734,1655,60,64,124
"1849",841,733,1875,41,33,74
"1850",2348,2151,2029,113,146,259
"1851",2232,2123,1168,37,48,85
"1852",1612,1459,2094,37,49,86
"1853",2126,1950,1673,51,60,111
"1854",2033,1939,3575,33,39,72
"1855",2048,1751,2907,88,101,189
"1856",1613,1500,2578,38,45,83
"1857",1305,1123,359,80,93,173
"1858",1902,1823,2480,37,48,85
"1859",1657,1601,31,42,36,78
"1860",1657,1555,36,62,55,117
"1861",1935,1839,48,35,39,74
"1862",2019,1920,50,49,50,99
"1863",1756,1602,1557,41,37,78
"1864",1728,1628,2315,53,53,106
"1865",2013,1920,5016,103,105,208
"1866",1815,1623,3474,50,58,108
"1867",1652,1506,27,42,41,83
"1868",2343,1950,45,53,55,108
"1869",2214,2113,51,54,43,97
"1870",1841,1749,38,136,139,275
"1871",2013,1923,40,193,203,396
"1872",1919,1825,44,79,85,164
"1873",2014,1922,50,44,52,96
"1874",1737,1556,29,72,61,133
"1875",2028,1905,41,63,75,138
"1876",1455,1348,3803,50,43,93
"1877",2158,1857,264,33,47,80
"1878",1939,1842,798,64,67,131
"1879",1504,1404,2556,39,39,78
"1880",2348,2051,49,33,41,74
"1881",2306,2008,3832,121,93,214
"1882",2149,2057,1590,104,112,216
"1883",1729,1614,2315,54,39,93
"1884",2252,2135,1168,57,60,117
"1885",1616,1457,2578,41,42,83
"1886",2231,2055,869,66,85,151
"1887",1636,1517,2094,61,67,128
"1888",2349,2309,709,124,129,253
"1889",1541,1502,1773,36,42,78
"1890",1300,1132,7,90,92,182
"1891",2233,2056,1673,118,126,244
"1892",917,830,201,37,40,77
"1893",1334,1242,24,34,42,76
"1894",1511,1419,30,41,49,90
"1895",1613,1522,32,73,82,155
"1896",1653,1544,36,58,44,102
"1897",204,120,60,249,260,509
"1898",1533,1410,1896,33,45,78
"1899",1231,1102,5060,41,47,88
"1900",1712,1543,29,47,48,95
"1901",1450,1400,3803,45,55,100
"1902",2158,1856,264,33,46,79
"1903",2110,2016,3575,70,76,146
"1904",2236,2139,1662,81,89,170
"1905",1359,1231,15,54,56,110
"1906",1919,1726,1557,124,121,245
"1907",1652,1539,2839,62,59,121
"1908",12,2119,49,57,69,126
"1909",2145,1935,3832,40,60,100
"1910",2028,1921,37,143,136,279
"1911",2126,2036,1590,81,91,172
"1912",2240,2019,2029,45,54,99
"1913",1028,918,2300,48,58,106
"1914",2248,1853,39,78,88,166
"1915",2313,2226,3428,43,51,94
"1916",1957,1911,5016,87,96,183
"1917",2158,2007,869,33,37,70
"1918",1956,1710,35,31,40,71
"1919",22,2140,3358,82,90,172
"1920",2012,1836,1264,62,71,133
"1921",1441,1341,2649,46,41,87
"1922",2134,1830,2122,39,40,79
"1923",1859,1812,2480,34,37,71
"1924",1201,1034,7,31,34,65
"1925",1703,1606,38,38,36,74
"1926",1535,1419,1896,35,54,89
"1927",1914,1819,798,39,44,83
"1928",1437,1242,1535,127,122,249
"1929",157,7,1536,197,197,394
"1930",1852,1756,37,47,51,98
"1931",2037,1944,1989,32,39,71
"1932",2228,2112,1168,33,37,70
"1933",1606,1450,2578,31,35,66
"1934",2123,1953,2678,58,63,121
"1935",2315,2225,3428,45,50,95
"1936",1946,1854,5016,76,79,155
"1937",2206,2043,1504,41,43,84
"1938",1421,1330,24,81,90,171
"1939",1856,1801,44,56,61,117
"1940",2253,2206,60,58,66,124
"1941",1536,1412,1896,36,47,83
"1942",2111,1859,2018,216,234,450
"1943",2108,2013,1590,63,68,131
"1944",2223,2130,1610,73,80,153
"1945",1736,1634,2383,76,69,145
"1946",2243,2128,1504,78,88,166
"1947",1127,825,2006,49,40,89
"1948",2120,1757,2008,120,95,215
"1949",2155,1908,2008,155,166,321
"1950",1958,1716,2008,38,54,92
"1951",1954,1708,2008,39,46,85
"1952",2029,1731,2008,69,69,138
"1953",1849,1548,2010,132,135,267
"1954",1759,1450,2010,76,75,151
"1955",1736,1432,2010,62,59,121
"1956",1710,1405,2010,33,32,65
"1957",1656,1542,2025,42,37,79
"1958",1704,1544,2025,48,39,87
"1959",1358,1110,2036,39,55,94
"1960",2217,2049,2042,68,79,147
"1961",2145,2017,2042,36,47,83
"1962",2241,1849,2044,99,70,169
"1963",2300,1957,2044,118,138,256
"1964",2212,1852,2044,70,73,143
"1965",1627,1510,2048,104,110,214
"1966",1516,1357,2048,33,37,70
"1967",1651,1532,2048,133,132,265
"1968",1600,1445,2048,62,66,128
"1969",106,2111,2050,143,131,274
"1970",29,2059,2050,106,119,225
"1971",2355,2032,2050,81,93,174
"1972",7,2108,2055,84,98,182
"1973",1202,1038,2058,106,83,189
"1974",1245,1141,2058,149,151,300
"1975",1122,1014,2058,66,64,130
"1976",2337,2022,2060,34,37,71
"1977",22,2132,2060,79,107,186
"1978",2039,1923,2062,53,48,101
"1979",2130,1959,2062,101,86,187
"1980",1400,1055,2064,36,40,76
"1981",1708,1557,2069,33,32,65
"1982",1256,1119,2079,147,139,286
"1983",1106,934,2079,37,34,71
"1984",1748,1659,2081,76,88,164
"1985",1457,1338,2082,136,133,269
"1986",1325,1156,2082,42,31,73
"1987",1431,1257,2083,93,72,165
"1988",1705,1536,2097,90,81,171
"1989",1611,1453,2097,36,38,74
"1990",1446,1113,2105,41,33,74
"1991",2013,1732,2122,80,77,157
"1992",2321,2222,2131,63,62,125
"1993",2326,2224,2131,68,64,132
"1994",1812,1700,2133,31,35,66
"1995",1900,1748,2133,79,83,162
"1996",2348,2011,2171,38,51,89
"1997",12,2041,2171,77,86,163
"1998",1515,1355,2174,49,55,104
"1999",1527,1359,2174,74,69,143
"2000",2109,2011,2186,68,71,139
"2001",21,2251,2192,98,96,194
"2002",1059,1006,2194,45,46,91
"2003",1840,1528,2198,67,73,140
"2004",1807,1512,2198,36,57,93
"2005",1538,1422,2200,163,167,330
"2006",1337,1208,2200,42,33,75
"2007",1359,1239,2200,64,64,128
"2008",1332,1214,2200,32,34,66
"2009",1736,1614,2204,98,99,197
"2010",1941,1824,2212,52,34,86
"2011",1926,1832,2212,35,42,77
"2012",1500,1352,2223,69,62,131
"2013",1143,805,2240,57,45,102
"2014",2203,1834,2244,164,174,338
"2015",1353,1055,2246,190,190,380
"2016",1128,825,2246,40,35,75
"2017",1237,1052,2249,59,37,96
"2018",1342,1224,2253,53,59,112
"2019",1241,1126,2254,195,181,376
"2020",952,856,2254,36,41,77
"2021",1436,1119,2268,38,54,92
"2022",2043,1736,2276,32,41,73
"2023",2056,1743,2276,45,48,93
"2024",2129,1818,2276,88,93,181
"2025",1434,1321,2277,106,101,207
"2026",1323,1208,2277,46,40,86
"2027",2234,2113,2280,118,123,241
"2028",2135,2017,2280,59,67,126
"2029",2111,1954,2280,35,44,79
"2030",2123,2000,2280,40,40,80
"2031",1636,1529,2282,43,44,87
"2032",14,2052,2288,96,92,188
"2033",2314,1958,2288,36,38,74
"2034",1104,933,2290,61,43,104
"2035",1648,1336,2295,58,67,125
"2036",1933,1623,2298,50,48,98
"2037",1159,1015,2302,76,77,153
"2038",1621,1458,2304,138,128,266
"2039",1324,1043,2305,93,113,206
"2040",1039,939,2311,34,39,73
"2041",1818,1502,2317,49,57,106
"2042",1832,1505,2317,66,60,126
"2043",2121,1829,2318,53,59,112
"2044",2122,1832,2318,54,62,116
"2045",2114,1809,2318,46,39,85
"2046",1718,1413,2333,48,48,96
"2047",1913,1620,2334,115,120,235
"2048",1746,1548,2336,108,88,196
"2049",1713,1518,2336,75,58,133
"2050",1455,1152,2340,52,57,109
"2051",1949,1805,2346,121,120,241
"2052",1854,1715,2346,68,70,138
"2053",2326,2222,2357,57,62,119
"2054",20,2322,2357,111,122,233
"2055",2337,2232,2357,68,72,140
"2056",2335,2223,2357,65,63,128
"2057",2156,2030,2361,68,70,138
"2058",1419,1226,2363,82,82,164
"2059",1712,1555,2375,76,85,161
"2060",2225,2051,2376,156,166,322
"2061",2025,1838,2376,36,33,69
"2062",1824,1518,2380,121,113,234
"2063",1633,1505,2388,41,31,72
"2064",1449,1351,2399,33,36,69
"2065",1758,1500,2405,44,50,94
"2066",2127,2040,2418,64,70,134
"2067",2110,2016,2418,65,61,126
"2068",2126,2044,2418,63,74,137
"2069",1502,1351,2421,151,141,292
"2070",2056,1933,2425,102,93,195
"2071",1648,1520,2427,63,65,128
"2072",1817,1624,2427,149,129,278
"2073",1412,1251,2429,75,79,154
"2074",1353,1215,2429,56,43,99
"2075",1415,1250,2429,78,78,156
"2076",1138,819,2432,45,49,94
"2077",1430,1254,2433,89,84,173
"2078",1353,1053,2435,153,148,301
"2079",1203,907,2435,65,70,135
"2080",1307,1015,2435,112,110,222
"2081",1913,1810,2442,153,145,298
"2082",1809,1712,2442,80,79,159
"2083",1730,1634,2442,50,49,99
"2084",1120,1003,2453,56,53,109
"2085",1421,1049,2462,143,124,267
"2086",1332,1025,2462,94,100,194
"2087",1313,936,2462,75,51,126
"2088",1947,1804,2465,93,79,172
"2089",938,830,2469,42,35,77
"2090",1223,939,2470,88,93,181
"2091",1142,854,2470,47,48,95
"2092",1737,1448,2472,76,88,164
"2093",1755,1429,2472,72,44,116
"2094",1658,1406,2472,34,46,80
"2095",1759,1606,2474,35,31,66
"2096",1942,1720,2474,138,105,243
"2097",3,2307,2481,210,217,427
"2098",2111,2007,2481,38,37,75
"2099",2056,1738,2488,62,62,124
"2100",2143,1823,2488,105,103,208
"2101",2035,1719,2488,41,43,84
"2102",2047,1727,2488,49,47,96
"2103",2333,2031,2488,219,235,454
"2104",2053,1746,2488,59,70,129
"2105",2312,1958,2488,194,198,392
"2106",2142,1832,2488,104,112,216
"2107",2058,1729,2492,99,99,198
"2108",2325,2147,2493,31,32,63
"2109",2327,2030,2496,226,237,463
"2110",1811,1635,2497,53,60,113
"2111",1525,1357,2499,57,42,99
"2112",1521,1420,2499,52,55,107
"2113",1326,1223,2501,55,53,108
"2114",1309,1209,2501,38,39,77
"2115",2136,1932,2511,42,42,84
"2116",2139,1921,2511,40,31,71
"2117",1900,1600,2520,291,301,592
"2118",1541,1220,2520,92,81,173
"2119",1012,811,2525,82,36,118
"2120",1007,837,2525,84,62,146
"2121",1008,856,2525,80,81,161
"2122",145,2357,2534,156,162,318
"2123",1834,1525,2550,59,65,124
"2124",1910,1541,2550,95,81,176
"2125",1124,1021,2557,149,145,294
"2126",1128,1040,2559,60,70,130
"2127",1211,1024,2559,103,54,157
"2128",1104,1015,2559,36,45,81
"2129",1944,1835,2562,73,65,138
"2130",1938,1842,2562,67,72,139
"2131",1719,1529,2569,60,39,99
"2132",1107,932,2569,51,37,88
"2133",1814,1507,2572,66,77,143
"2134",1004,754,2573,50,34,84
"2135",958,804,2573,52,44,96
"2136",1557,1502,2581,36,42,78
"2137",1557,1505,2581,36,45,81
"2138",1553,1457,2581,32,37,69
"2139",1204,853,2586,91,93,184
"2140",1602,1502,2591,38,32,70
"2141",1605,1503,2591,36,33,69
"2142",2208,2051,2594,235,234,469
"2143",1930,1759,2594,67,59,126
"2144",1854,1745,2594,47,54,101
"2145",1915,1745,2594,52,45,97
"2146",4,2111,2597,75,85,160
"2147",2345,2050,2597,77,85,162
"2148",2013,1826,2598,49,51,100
"2149",2038,1848,2598,55,63,118
"2150",2038,1840,2598,55,55,110
"2151",1737,1505,2599,66,75,141
"2152",1736,1552,2601,72,66,138
"2153",1214,856,2612,36,36,72
"2154",1421,1110,2618,143,150,293
"2155",1512,1219,2618,194,219,413
"2156",1632,1529,2625,38,44,82
"2157",1721,1607,2625,87,82,169
"2158",1658,1350,2629,39,35,74
"2159",1818,1509,2629,127,119,246
"2160",1626,1541,2631,51,61,112
"2161",1118,1010,2649,36,43,79
"2162",1158,1043,2649,74,78,152
"2163",1134,1009,2649,50,44,94
"2164",1510,1200,2652,62,65,127
"2165",2308,2143,2654,49,38,87
"2166",1927,1801,2675,52,31,83
"2167",1918,1817,2675,43,47,90
"2168",929,809,2687,31,39,70
"2169",10,2324,2692,116,124,240
"2170",2340,2248,2692,91,93,184
"2171",1953,1843,2705,135,138,273
"2172",1738,1435,2715,39,45,84
"2173",1943,1652,2728,45,52,97
"2174",2026,1739,2728,93,99,192
"2175",2135,2046,2731,95,101,196
"2176",1849,1728,2748,85,83,168
"2177",1920,1809,2748,85,92,177
"2178",1638,1527,2769,115,102,217
"2179",1559,1447,2769,72,58,130
"2180",1720,1608,2769,153,139,292
"2181",1516,1423,2769,33,38,71
"2182",1522,1416,2769,39,31,70
"2183",1831,1726,2773,203,211,414
"2184",1708,1539,2778,68,62,130
"2185",1639,1523,2778,35,42,77
"2186",2125,1746,2780,262,266,528
"2187",20,2138,2782,87,103,190
"2188",2346,2103,2782,53,68,121
"2189",2334,2048,2782,41,53,94
"2190",2335,2049,2782,42,54,96
"2191",1710,1412,2791,32,47,79
"2192",1119,1003,2792,53,63,116
"2193",2346,2045,2796,277,274,551
"2194",1126,947,2799,46,47,93
"2195",2332,2201,2800,116,116,232
"2196",2314,2228,2803,71,78,149
"2197",2156,2040,2804,68,80,148
"2198",2145,2022,2804,57,62,119
"2199",1503,1343,2811,52,50,102
"2200",1642,1517,2811,151,142,293
"2201",1453,1339,2811,42,44,86
"2202",1533,1416,2811,87,83,170
"2203",1318,1207,2817,44,42,86
"2204",1314,1201,2817,38,31,69
"2205",2332,2045,2822,41,55,96
"2206",2330,2035,2822,36,45,81
"2207",148,40,2823,109,100,209
"2208",1311,1209,2826,40,39,79
"2209",1313,1222,2826,42,52,94
"2210",2139,2030,2830,69,75,144
"2211",1213,1102,2833,45,42,87
"2212",1223,1120,2833,55,60,115
"2213",1303,1147,2833,90,87,177
"2214",1907,1747,2834,49,42,91
"2215",1926,1813,2834,58,58,116
"2216",1839,1720,2840,45,47,92
"2217",1500,1336,2844,37,36,73
"2218",1518,1345,2844,50,50,100
"2219",1503,1332,2844,35,32,67
"2220",1507,1321,2847,102,101,203
"2221",2224,2024,2873,114,104,218
"2222",2023,1842,2873,45,42,87
"2223",2154,2017,2873,136,137,273
"2224",2117,1937,2873,47,57,104
"2225",956,903,2879,50,58,108
"2226",1022,924,2879,76,79,155
"2227",1556,1422,2881,86,97,183
"2228",2143,1932,2882,143,122,265
"2229",1728,1618,2884,59,48,107
"2230",1833,1738,2884,122,128,250
"2231",1749,1648,2884,78,78,156
"2232",1137,1020,2885,49,50,99
"2233",1156,1038,2891,166,163,329
"2234",2028,1930,2902,104,100,204
"2235",2104,1955,2907,46,35,81
"2236",2213,2114,2907,115,114,229
"2237",1101,928,2908,33,31,64
"2238",1109,940,2908,36,43,79
"2239",1320,1152,2908,170,173,343
"2240",1246,1006,2916,65,35,100
"2241",1310,1056,2916,134,121,255
"2242",1347,1143,2916,126,132,258
"2243",1849,1732,2920,64,72,136
"2244",2007,1850,2920,159,165,324
"2245",1447,1225,2924,46,35,81
"2246",1835,1716,2931,40,35,75
"2247",1719,1616,2936,48,41,89
"2248",1916,1828,2936,170,173,343
"2249",32,2256,2938,159,166,325
"2250",2259,2113,2938,66,63,129
"2251",1824,1632,2944,64,37,101
"2252",1808,1645,2944,48,50,98
"2253",1840,1703,2944,94,93,187
"2254",1648,1509,2945,39,34,73
"2255",1935,1720,2948,79,95,174
"2256",1903,1623,2948,47,38,85
"2257",2037,1754,2948,132,122,254
"2258",1913,1625,2948,48,33,81
"2259",2157,2037,2954,72,72,144
"2260",2149,2029,2954,49,49,98
"2261",1108,933,2967,43,38,81
"2262",1217,1040,2967,107,105,212
"2263",2156,2048,2975,108,108,216
"2264",2345,2150,2976,36,35,71
"2265",1710,1406,2980,47,41,88
"2266",1548,1429,2998,73,84,157
"2267",1519,1351,2998,49,46,95
"2268",1536,1404,2998,61,59,120
"2269",1630,1440,2998,115,95,210
"2270",1616,1350,3004,48,50,98
"2271",1618,1348,3004,50,48,98
"2272",1724,1458,3004,60,62,122
"2273",1926,1805,3005,57,35,92
"2274",1947,1851,3005,74,76,150
"2275",1930,1831,3005,57,56,113
"2276",2230,2105,3016,67,80,147
"2277",2323,2128,3016,95,83,178
"2278",2208,2021,3016,45,36,81
"2279",1023,920,3021,93,85,178
"2280",2158,2043,3022,52,53,105
"2281",2207,2054,3022,61,64,125
"2282",2041,1926,3027,83,76,159
"2283",2039,1940,3027,81,90,171
"2284",2005,1847,3027,47,37,84
"2285",2000,1857,3027,42,47,89
"2286",1145,813,3032,50,41,91
"2287",1712,1520,3033,69,55,124
"2288",1345,1143,3035,42,33,75
"2289",7,2105,3036,43,50,93
"2290",2232,2103,3038,73,98,171
"2291",1106,930,3040,78,70,148
"2292",2329,2048,3050,63,83,146
"2293",20,2126,3050,126,131,257
"2294",2357,2032,3050,103,77,180
"2295",33,2119,3050,139,124,263
"2296",2251,2000,3050,37,45,82
"2297",2255,2010,3050,46,55,101
"2298",1119,1003,3059,148,153,301
"2299",947,815,3059,56,45,101
"2300",1248,1132,3060,73,72,145
"2301",1822,1504,3078,52,69,121
"2302",1836,1457,3078,59,58,117
"2303",1201,938,3088,66,38,104
"2304",1459,1311,3092,91,96,187
"2305",1442,1248,3092,69,73,142
"2306",1237,906,3096,109,101,210
"2307",1158,817,3096,64,57,121
"2308",1215,820,3096,82,55,137
"2309",1543,1236,3097,103,101,204
"2310",2215,2040,3101,126,120,246
"2311",2152,2041,3105,69,81,150
"2312",2111,2002,3105,41,42,83
"2313",1201,1052,3119,32,36,68
"2314",1520,1413,3120,65,79,144
"2315",2202,2031,3127,119,131,250
"2316",17,2117,3137,78,92,170
"2317",1301,1211,3138,82,86,168
"2318",1316,1227,3138,90,102,192
"2319",1436,1205,3157,55,40,95
"2320",1336,949,5802,143,144,287
"2321",1722,1509,5803,52,45,97
"2322",1336,1019,5807,98,99,197
"2323",1244,930,5807,46,50,96
"2324",1245,932,5807,47,52,99
"2325",1941,1617,5809,127,122,249
"2326",1815,1448,5809,41,33,74
"2327",2218,1835,5809,289,265,554
"2328",1802,1402,5810,88,52,140
"2329",1416,1305,5810,43,50,93
"2330",848,707,6698,80,67,147
"2331",1255,910,5817,107,105,212
"2332",1652,1524,5819,56,54,110
"2333",2345,2222,5823,59,62,121
"2334",2352,2236,5823,66,76,142
"2335",1224,1057,1134,119,115,234
"2336",1530,1254,1155,82,89,171
"2337",1523,1251,1155,75,86,161
"2338",2337,1923,1107,188,113,301
"2339",2141,1858,1107,72,88,160
"2340",1508,1412,1107,63,52,115
"2341",1544,1453,1107,99,93,192
"2342",1305,1144,5800,121,115,236
"2343",1253,1111,5800,109,82,191
"2344",1228,934,5800,49,49,98
"2345",1305,943,5800,86,58,144
"2346",1413,1111,5800,154,146,300
"2347",1245,940,5800,66,55,121
"2348",1329,1024,5800,110,99,209
"2349",1257,1006,5800,78,81,159
"2350",1429,1307,5800,51,52,103
"2351",1844,1546,5801,63,61,124
"2352",1846,1530,5801,68,50,118
"2353",1824,1531,5801,43,46,89
"2354",2140,1851,5801,239,246,485
"2355",1140,955,5816,75,53,128
"2356",1701,1426,4548,37,54,91
"2357",1742,1432,4548,78,60,138
"2358",2325,2110,5816,119,115,234
"2359",1109,951,5816,44,49,93
"2360",1604,1312,1142,141,112,253
"2361",47,2352,1143,144,147,291
"2362",6,2144,1153,108,114,222
"2363",1222,1102,1188,117,112,229
"2364",112,2353,1123,156,158,314
"2365",1152,1046,1124,76,71,147
"2366",1111,1018,1124,35,43,78
"2367",1041,839,5835,77,74,151
"2368",956,808,5835,32,43,75
"2369",1024,812,5836,60,47,107
"2370",2103,1722,5836,75,82,157
"2371",2336,2005,5836,228,245,473
"2372",1457,1124,5840,59,49,108
"2373",1354,1155,5841,61,60,121
"2374",2015,1838,5845,36,33,69
"2375",1704,1501,5846,39,31,70
"2376",1735,1536,5846,70,66,136
"2377",1208,1047,1161,110,107,217
"2378",1242,1120,1161,144,140,284
"2379",1037,845,1166,32,31,63
"2380",1602,1343,1173,142,134,276
"2381",1729,1447,1174,126,107,233
"2382",2324,2143,1179,40,33,73
"2383",1638,1314,1183,154,169,323
"2384",1624,1337,5828,122,113,235
"2385",1726,1421,5830,93,71,164
"2386",1059,933,5832,36,33,69
"2387",200,44,5834,200,209,409
"2388",1905,1712,5827,97,102,199
"2389",1918,1717,5827,110,107,217
"2390",1839,1543,5801,61,63,124
"2391",2106,1944,5801,94,96,190
"2392",2120,1958,5801,108,110,218
"2393",2200,2004,5801,148,116,264
"2394",2021,1901,5801,54,53,107
"2395",2037,1903,5801,65,55,120
"2396",2103,1954,5801,96,106,202
"2397",2306,2128,1145,31,38,69
"2398",1750,1640,1109,117,105,222
"2399",39,2054,7037,113,119,232
"2400",147,2116,7037,181,141,322
"2401",33,2035,7037,89,82,171
"2402",2347,2000,7037,43,47,90
"2403",15,2023,7037,89,88,177
"2404",2319,1929,7037,33,34,67
"2405",2344,1953,7037,58,58,116
"2406",2343,2017,7037,45,70,115
"2407",1136,1011,6726,46,71,117
"2408",1125,943,6726,37,45,82
"2409",1423,1243,6726,198,208,406
"2410",2208,1951,4455,73,76,149
"2411",2134,1914,4455,39,39,78
"2412",1451,1230,4461,350,360,710
"2413",1655,1550,1119,67,60,127
"2414",1316,1025,1112,35,33,68
"2415",2338,2228,1114,68,78,146
"2416",1109,1007,1141,41,37,78
"2417",2348,2126,1132,114,126,240
"2418",1209,1058,1134,98,98,196
"2419",1655,1440,4489,32,33,65
"2420",1212,928,104,63,53,116
"2421",1900,1631,108,48,51,99
"2422",1245,1012,109,88,72,160
"2423",2026,1759,346,31,37,68
"2424",2001,1620,552,117,130,247
"2425",1151,943,855,34,43,77
"2426",1158,929,855,45,33,78
"2427",1153,932,855,36,32,68
"2428",2040,1729,1978,97,109,206
"2429",1410,1104,1015,35,49,84
"2430",1239,916,944,33,31,64
"2431",1439,1103,1015,64,48,112
"2432",1729,1413,1697,119,123,242
"2433",2127,1939,587,79,99,178
"2434",1740,1614,269,46,74,120
"2435",2223,1905,959,94,95,189
"2436",2124,1812,959,35,42,77
"2437",1359,1228,2413,124,108,232
"2438",1854,1815,791,34,40,74
"2439",2251,2206,3665,96,96,192
"2440",1205,1049,5,60,74,134
"2441",1048,902,3306,53,52,105
"2442",1228,853,1628,43,58,101
"2443",1443,1328,671,143,158,301
"2444",2004,1903,584,44,43,87
"2445",1517,1415,1179,37,35,72
"2446",1813,1528,2459,223,233,456
"2447",1505,1253,136,55,38,93
"2448",1743,1556,2653,38,46,84
"2449",2228,2043,2771,73,78,151
"2450",1159,1032,3133,34,32,66
"2451",1428,1157,1099,88,77,165
"2452",2104,1937,303,39,47,86
"2453",2212,2114,51,57,49,106
"2454",1813,1718,42,43,48,91
"2455",1850,1749,44,50,49,99
"2456",1925,1828,46,55,58,113
"2457",1942,1848,48,42,48,90
"2458",1950,1819,39,55,54,109
"2459",1925,1813,1276,50,38,88
"2460",2001,1854,584,41,34,75
"2461",1506,1332,752,71,67,138
"2462",1450,1335,625,120,120,240
"2463",9,2110,49,59,65,124
"2464",1849,1750,208,39,45,84
"2465",1909,1813,922,39,38,77
"2466",1645,1523,709,55,58,113
"2467",2119,1957,1233,54,57,111
"2468",1850,1733,726,45,43,88
"2469",1552,1417,23,37,52,89
"2470",1337,1242,24,37,42,79
"2471",1548,1452,32,48,52,100
"2472",1630,1536,34,60,66,126
"2473",2015,1921,42,165,171,336
"2474",1411,1251,671,111,121,232
"2475",1333,1203,15,38,38,76
"2476",1647,1538,464,132,128,260
"2477",1428,1326,752,33,61,94
"2478",1515,1349,136,65,94,159
"2479",1321,1218,625,31,43,74
"2480",1320,1218,2610,45,43,88
"2481",1932,1842,922,62,67,129
"2482",1252,1109,9,32,44,76
"2483",1913,1805,726,68,75,143
"2484",1612,1529,471,42,49,91
"2485",1912,1828,791,52,53,105
"2486",2200,2113,3665,45,43,88
"2487",2303,2148,3925,83,103,186
"2488",1733,1602,23,138,157,295
"2489",110,2341,919,275,291,566
"2490",338,21,45,288,321,609
"2491",128,40,51,253,255,508
"2492",1950,1903,563,80,83,163
"2493",1711,1617,28,191,197,388
"2494",1811,1712,30,221,222,443
"2495",1724,1629,32,144,149,293
"2496",1804,1705,34,154,155,309
"2497",1850,1755,38,140,145,285
"2498",1934,1805,42,124,95,219
"2499",2243,2151,46,253,261,514
"2500",2144,2036,48,164,156,320
"2501",131,38,50,361,368,729
"2502",2209,2102,56,74,62,136
"2503",2304,2145,39,249,260,509
"2504",1937,1846,1276,62,71,133
"2505",54,2154,47,124,139,263
"2506",2308,2209,29,418,419,837
"2507",110,12,55,160,162,322
"2508",2003,1856,386,88,81,169
"2509",1515,1411,1179,35,31,66
"2510",2333,2236,2378,143,151,294
"2511",1919,1814,869,184,209,393
"2512",1853,1726,2653,108,136,244
"2513",2257,2133,2771,102,128,230
"2514",1728,1420,19,108,110,218
"2515",53,2204,49,103,119,222
"2516",2054,1843,27,229,248,477
"2517",1909,1803,208,59,58,117
"2518",1803,1635,291,148,125,273
"2519",2221,2122,542,76,77,153
"2520",2040,1941,3681,80,81,161
"2521",2257,2052,3772,57,72,129
"2522",1819,1659,504,54,54,108
"2523",1555,1414,604,60,39,99
"2524",225,2256,41,255,291,546
"2525",2215,2103,303,110,133,243
"2526",1554,1503,2477,44,48,92
"2527",2244,2058,3488,94,103,197
"2528",2142,1849,35,132,134,266
"2529",1602,1259,2761,62,54,116
"2530",601,144,3509,426,339,765
"2531",1629,1508,709,39,43,82
"2532",37,2320,2585,237,240,477
"2533",1429,1119,1111,45,32,77
"2534",1624,1331,1540,40,46,86
"2535",1010,717,1248,66,79,145
"2536",1637,1347,1111,173,180,353
"2537",1429,1135,1590,124,129,253
"2538",2324,2021,8,261,262,523
"2539",1624,1335,1540,40,50,90
"2540",2007,1707,8,65,68,133
"2541",2157,1842,8,174,163,337
"2542",1422,1125,1111,38,38,76
"2543",1634,1319,1540,50,34,84
"2544",2352,2053,2095,162,163,325
"2545",1633,1335,5003,54,55,109
"2546",1702,1414,5003,83,94,177
"2547",1615,1319,5003,36,39,75
"2548",1818,1527,5003,159,167,326
"2549",2119,1755,5214,159,180,339
"2550",2003,1601,5214,81,68,149
"2551",2049,1720,5214,127,147,274
"2552",1906,1740,5229,69,80,149
"2553",1905,1744,5229,68,84,152
"2554",2334,2020,5237,144,130,274
"2555",2149,1914,5237,39,64,103
"2556",1618,1317,5426,43,43,86
"2557",1636,1351,5426,61,77,138
"2558",903,749,143,87,94,181
"2559",834,718,143,58,63,121
"2560",907,736,143,91,81,172
"2561",1758,1629,376,48,40,88
"2562",1817,1634,376,67,45,112
"2563",1839,1702,376,89,73,162
"2564",1408,1112,298,41,34,75
"2565",2151,1834,292,91,65,156
"2566",1539,1255,286,31,38,69
"2567",2236,1959,296,61,71,132
"2568",227,2349,292,367,380,747
"2569",1118,820,290,128,130,258
"2570",1440,1145,298,77,70,147
"2571",2143,1902,298,500,507,1007
"2572",1621,1333,286,78,81,159
"2573",2333,2029,296,118,106,224
"2574",2055,1930,2870,80,65,145
"2575",2253,2140,2870,198,195,393
"2576",2021,1913,2870,46,48,94
"2577",2044,1925,2870,69,60,129
"2578",2024,1919,2870,49,54,103
"2579",2023,1904,2870,48,39,87
"2580",1255,1108,2958,95,53,148
"2581",1325,1205,2958,125,110,235
"2582",1205,1058,2958,35,38,73
"2583",1237,1126,3210,167,166,333
"2584",1646,1525,3216,206,195,401
"2585",1417,1249,3216,57,39,96
"2586",1418,1256,3216,58,46,104
"2587",1012,856,3265,182,176,358
"2588",2204,2046,3328,74,66,140
"2589",2149,2046,3328,59,66,125
"2590",1908,1748,3390,183,173,356
"2591",1729,1621,3390,84,86,170
"2592",1840,1729,3390,155,154,309
"2593",1900,1753,3390,175,178,353
"2594",1849,1728,3390,164,153,317
"2595",2329,2119,3717,124,149,273
"2596",2319,2109,3717,114,139,253
"2597",2308,1948,3717,103,58,161
"2598",2223,1942,3717,68,52,120
"2599",2201,1924,3717,46,34,80
"2600",2,2014,3717,167,84,251
"2601",2104,1841,3786,184,196,380
"2602",1922,1645,3786,87,75,162
"2603",1918,1648,3786,83,78,161
"2604",2045,1758,3786,170,148,318
"2605",1946,1721,3786,111,111,222
"2606",1548,1333,3796,128,148,276
"2607",1506,1233,3796,86,88,174
"2608",1420,1146,3796,50,41,91
"2609",1448,1239,3796,78,94,172
"2610",1436,1212,3796,66,67,133
"2611",1552,1324,3796,142,139,281
"2612",1435,1215,3796,65,70,135
"2613",1030,817,3859,70,92,162
"2614",949,720,3859,34,40,74
"2615",1039,827,3859,84,107,191
"2616",1157,1054,493,107,119,226
"2617",1103,1006,493,53,71,124
"2618",2302,2201,653,92,101,193
"2619",2240,2137,653,70,77,147
"2620",2237,2144,653,67,84,151
"2621",924,821,1225,64,71,135
"2622",2153,1830,1294,43,40,83
"2623",1638,1534,1298,73,79,152
"2624",1400,1256,1505,35,46,81
"2625",1428,1317,1505,63,67,130
"2626",1747,1647,1505,262,277,539
"2627",1454,1359,1505,89,109,198
"2628",1422,1102,2137,52,52,104
"2629",1403,1049,2137,33,39,72
"2630",2253,1916,731,103,51,154
"2631",2228,1918,731,78,53,131
"2632",2159,1908,731,49,38,87
"2633",2217,1926,731,67,56,123
"2634",2208,1915,731,58,45,103
"2635",2217,1937,731,67,67,134
"2636",2242,1951,731,92,81,173
"2637",2128,1657,624,82,82,164
"2638",5,1839,624,239,184,423
"2639",2128,1716,624,82,101,183
"2640",141,2013,624,335,278,613
"2641",2140,1700,624,94,85,179
"2642",2130,1649,624,84,74,158
"2643",1504,1040,620,223,220,443
"2644",2116,1703,624,70,88,158
"2645",2039,1606,624,33,31,64
"2646",2026,1855,59,77,80,157
"2647",1337,1040,309,139,110,249
"2648",36,2029,310,65,89,154
"2649",1446,1349,379,58,59,117
"2650",2039,1707,558,34,56,90
"2651",1813,1614,599,140,114,254
"2652",2322,2016,616,83,71,154
"2653",2121,1719,632,53,81,134
"2654",23,2046,644,109,111,220
"2655",2051,1758,667,41,33,74
"2656",1829,1430,686,281,240,521
"2657",1423,1131,706,230,246,476
"2658",11,2210,770,69,80,149
"2659",2335,1942,1417,36,37,73
"2660",1553,1500,1541,36,40,76
"2661",1933,1550,1562,118,85,203
"2662",2252,1851,1632,39,66,105
"2663",1953,1852,1689,43,82,125
"2664",2332,1951,1748,57,36,93
"2665",1619,1225,1751,140,95,235
"2666",1543,1229,1756,41,48,89
"2667",2325,2004,1830,53,54,107
"2668",2317,2042,1833,86,87,173
"2669",1613,1511,1838,32,31,63
"2670",2210,1922,1858,100,72,172
"2671",1952,1818,59,43,43,86
"2672",1110,1006,1679,49,46,95
"2673",2218,1917,1840,188,202,390
"2674",2038,1927,5,111,107,218
"2675",1944,1621,1844,79,101,180
"2676",1929,1523,62,31,58,89
"2677",2323,2200,299,47,55,102
"2678",2258,1943,1451,34,43,77
"2679",2011,1654,1840,61,59,120
"2680",1646,1355,206,37,50,87
"2681",2225,2100,297,110,115,225
"2682",1441,1332,379,53,42,95
"2683",2008,1851,397,60,66,126
"2684",2232,2125,479,141,135,276
"2685",1407,955,510,52,65,117
"2686",1216,959,542,34,34,68
"2687",1240,1032,559,47,42,89
"2688",2106,1838,570,46,48,94
"2689",1848,1559,767,47,34,81
"2690",1808,1614,795,42,34,76
"2691",2249,1957,1506,50,63,113
"2692",2014,1919,1603,90,89,179
"2693",1758,1637,1787,51,42,93
"2694",1852,1725,1821,144,155,299
"2695",2035,1730,1840,76,90,166
"2696",1929,1825,5,39,37,76
"2697",2052,1908,150,48,33,81
"2698",1612,1330,267,43,35,78
"2699",2156,2054,397,143,159,302
"2700",2122,1746,412,34,51,85
"2701",1546,1323,663,145,108,253
"2702",2100,1841,667,63,76,139
"2703",1823,1456,744,97,106,203
"2704",2350,2127,770,53,37,90
"2705",1805,1506,1562,34,41,75
"2706",1933,1851,1603,54,61,115
"2707",1445,1305,1605,75,75,150
"2708",1429,1249,1629,36,34,70
"2709",1402,1130,1646,74,70,144
"2710",2351,2118,1889,215,193,408
"2711",1921,1832,35,37,42,79
"2712",2035,1623,62,97,118,215
"2713",1721,1331,326,33,41,74
"2714",1457,1355,379,69,65,134
"2715",17,2300,442,108,115,223
"2716",1137,829,586,42,49,91
"2717",128,2209,644,174,194,368
"2718",1958,1731,767,117,126,243
"2719",2353,2040,1451,89,100,189
"2720",2216,2031,1511,130,131,261
"2721",2316,2019,1630,51,59,110
"2722",2339,2019,190,69,69,138
"2723",2142,1944,195,60,44,104
"2724",1610,1119,212,48,64,112
"2725",1536,1245,270,116,95,211
"2726",1333,1203,352,31,38,69
"2727",1911,1613,370,146,118,264
"2728",2210,2106,423,67,71,138
"2729",2146,1928,489,51,53,104
"2730",2051,1840,570,31,50,81
"2731",1727,1556,599,94,96,190
"2732",1318,1218,723,40,48,88
"2733",30,2223,770,88,93,181
"2734",1814,1627,795,48,47,95
"2735",2019,1642,1648,54,42,96
"2736",1530,1347,1695,31,32,63
"2737",2015,1733,1750,105,93,198
"2738",2035,1856,1795,59,66,125
"2739",43,2235,1837,59,80,139
"2740",1944,1752,1846,62,52,114
"2741",2051,1838,1889,54,63,117
"2742",2307,2118,195,145,138,283
"2743",16,1939,310,45,39,84
"2744",1204,925,346,39,40,79
"2745",1800,1541,370,75,86,161
"2746",1554,1124,432,33,44,77
"2747",1902,1442,532,67,77,144
"2748",1305,1042,542,78,77,155
"2749",1645,1421,546,135,159,294
"2750",2139,1926,570,79,96,175
"2751",2244,1816,632,136,138,274
"2752",2308,1928,644,34,33,67
"2753",2259,2010,670,101,75,176
"2754",2005,1726,746,179,176,355
"2755",2,2132,770,60,42,102
"2756",2258,1950,1427,231,200,431
"2757",2339,1917,1632,86,92,178
"2758",1340,1112,1646,47,52,99
"2759",2255,1842,1676,177,177,354
"2760",1048,801,1746,43,36,79
"2761",111,2052,1776,97,92,189
"2762",1712,1305,1832,52,75,127
"2763",2342,2100,1833,111,105,216
"2764",27,2207,1837,43,52,95
"2765",2003,1831,59,54,56,110
"2766",2031,1807,246,133,147,280
"2767",1823,1659,275,67,76,143
"2768",1731,1552,599,98,92,190
"2769",1805,1525,746,59,55,114
"2770",2210,1931,1427,183,181,364
"2771",2124,2041,1441,44,56,100
"2772",18,2207,1833,147,172,319
"2773",2053,1916,150,44,41,85
"2774",1611,1125,432,50,45,95
"2775",1409,1256,499,41,71,112
"2776",1903,1426,532,68,61,129
"2777",2308,1852,632,160,174,334
"2778",2353,1940,732,32,35,67
"2779",2014,1743,1427,67,73,140
"2780",2324,2004,1451,60,64,124
"2781",1557,1129,1476,77,64,141
"2782",2129,1936,1511,83,76,159
"2783",1449,1058,1544,48,43,91
"2784",2242,1929,1586,43,39,82
"2785",2355,1922,1632,102,97,199
"2786",1829,1331,1832,129,101,230
"2787",1817,1318,1836,92,48,140
"2788",2356,2239,442,87,94,181
"2789",1717,1446,546,169,181,350
"2790",2239,2156,820,56,66,122
"2791",1945,1711,1427,38,41,79
"2792",133,2246,1630,103,121,224
"2793",38,2132,1748,123,137,260
"2794",2322,2104,1833,91,109,200
"2795",1923,1549,1844,63,74,137
"2796",2339,1919,1888,71,84,155
"2797",1628,1147,382,39,36,75
"2798",2142,2043,423,79,83,162
"2799",1725,1621,1589,32,51,83
"2800",1412,1240,1719,53,65,118
"2801",1230,1143,220,142,158,300
"2802",1637,1412,270,177,182,359
"2803",1924,1640,370,159,145,304
"2804",1303,844,408,53,64,117
"2805",1719,1331,409,89,94,183
"2806",2053,1825,570,33,35,68
"2807",1639,1539,623,57,64,121
"2808",1413,1221,663,47,46,93
"2809",2338,2100,670,140,125,265
"2810",1256,1155,741,46,40,86
"2811",150,2233,770,168,103,271
"2812",1957,1741,1750,87,101,188
"2813",2036,1946,1779,101,111,212
"2814",1357,1051,1,67,86,153
"2815",1831,1509,73,201,204,405
"2816",1625,1405,146,37,50,87
"2817",2114,1943,195,32,43,75
"2818",2319,1943,250,54,53,107
"2819",1500,1404,379,72,74,146
"2820",1631,1517,599,38,57,95
"2821",2254,2021,616,55,76,131
"2822",1226,819,626,59,54,113
"2823",1833,1712,795,67,92,159
"2824",1958,1719,1427,51,49,100
"2825",2228,1721,682,104,81,185
"2826",2353,2011,1488,44,51,95
"2827",2048,1850,1889,51,75,126
"2828",1346,1009,1,56,44,100
"2829",1742,1636,33,57,56,113
"2830",921,820,128,43,50,93
"2831",1335,1215,352,108,125,233
"2832",2243,2045,489,108,130,238
"2833",2131,1852,570,71,62,133
"2834",2231,2000,670,73,65,138
"2835",57,2230,770,115,100,215
"2836",2230,1930,1506,31,36,67
"2837",2321,2002,1830,49,52,101
"2838",2027,1927,5,98,105,203
"2839",1716,1613,6,44,43,87
"2840",1942,1848,35,58,58,116
"2841",1956,1827,59,47,52,99
"2842",1607,1124,106,46,39,85
"2843",1718,1426,146,90,71,161
"2844",2107,1946,150,58,71,129
"2845",1939,1552,158,61,67,128
"2846",1427,1234,197,72,44,116
"2847",2104,1640,210,38,50,88
"2848",1745,1131,212,143,76,219
"2849",1502,954,232,63,35,98
"2850",1539,1437,241,87,77,164
"2851",1928,1657,246,70,77,147
"2852",2345,2013,250,80,83,163
"2853",1559,1230,267,90,40,130
"2854",10,2002,310,39,62,101
"2855",1532,1357,323,92,62,154
"2856",1455,1208,352,113,43,156
"2857",1754,1343,358,214,193,407
"2858",1751,1522,370,66,67,133
"2859",1615,1449,379,147,119,266
"2860",1658,1127,382,90,42,132
"2861",2027,1903,397,79,78,157
"2862",1741,1309,409,111,72,183
"2863",2226,1834,412,98,99,197
"2864",2154,2053,423,51,58,109
"2865",1918,1527,458,152,152,304
"2866",2030,1448,482,160,103,263
"2867",2309,1954,500,34,49,83
"2868",1951,1904,520,68,79,147
"2869",2202,1926,570,102,96,198
"2870",1634,1503,599,41,43,84
"2871",2234,1942,616,35,37,72
"2872",1638,1519,623,56,44,100
"2873",2333,2003,644,59,68,127
"2874",2239,1958,670,81,63,144
"2875",2137,1656,682,53,56,109
"2876",1535,1131,686,107,61,168
"2877",125,2107,732,124,122,246
"2878",1834,1507,744,101,117,218
"2879",1831,1526,746,85,56,141
"2880",1910,1801,763,68,66,134
"2881",1927,1635,767,86,70,156
"2882",3,2153,770,61,63,124
"2883",1901,1551,786,137,141,278
"2884",2351,2012,1417,52,67,119
"2885",1540,1110,1448,107,40,147
"2886",2302,1937,1451,38,37,75
"2887",1636,1504,1466,38,34,72
"2888",1654,1123,1476,134,58,192
"2889",2346,2011,1488,37,51,88
"2890",1605,1501,1541,48,41,89
"2891",1436,1048,1544,35,33,68
"2892",1823,1450,1548,108,95,203
"2893",1844,1513,1562,69,48,117
"2894",2235,1930,1586,36,40,76
"2895",1355,1234,1620,71,49,120
"2896",55,2204,1630,150,164,314
"2897",8,2209,1644,61,69,130
"2898",1355,1126,1646,62,66,128
"2899",2023,1654,1648,58,54,112
"2900",2129,1720,1676,91,95,186
"2901",1155,955,1679,94,35,129
"2902",2029,1630,1688,42,35,77
"2903",2042,1915,1689,92,105,197
"2904",1552,1130,1690,108,55,163
"2905",2332,2215,1717,46,65,111
"2906",1304,1012,1723,112,42,154
"2907",1146,903,1746,101,98,199
"2908",2357,2050,1748,82,95,177
"2909",1556,1138,1751,117,48,165
"2910",1407,1101,1767,113,91,204
"2911",44,2041,1776,70,81,151
"2912",1936,1835,1779,41,40,81
"2913",1845,1454,1790,93,64,157
"2914",2340,2017,1830,68,67,135
"2915",2234,2006,1833,43,51,94
"2916",1935,1517,1836,170,167,337
"2917",121,2259,1837,97,104,201
"2918",1640,1524,1838,59,44,103
"2919",1852,1523,1844,32,48,80
"2920",1926,1749,1846,44,49,93
"2921",1753,1352,1851,59,42,101
"2922",2134,1917,1858,64,67,131
"2923",1532,1257,1882,122,82,204
"2924",1750,1346,60,77,101,178
"2925",1435,1330,323,35,35,70
"2926",2149,1851,570,89,61,150
"2927",2245,2001,670,87,66,153
"2928",42,2237,770,100,107,207
"2929",2247,1941,1506,48,47,95
"2930",2247,1931,1586,48,41,89
"2931",1421,1002,1,31,37,68
"2932",1854,1753,33,132,133,265
"2933",2048,1929,150,44,54,98
"2934",146,2150,310,143,170,313
"2935",1633,1143,382,37,32,69
"2936",2032,1914,397,59,59,118
"2937",7,1922,582,38,32,70
"2938",2331,1939,658,38,34,72
"2939",2052,1800,667,55,35,90
"2940",1049,922,799,36,37,73
"2941",2335,2005,1417,41,60,101
"2942",1606,1431,1695,53,57,110
"2943",1221,1011,1714,42,45,87
"2944",2249,2103,47,127,123,250
"2945",2003,1843,59,54,68,122
"2946",1816,1533,370,91,78,169
"2947",1608,1122,382,40,37,77
"2948",1628,1229,409,38,32,70
"2949",2142,2048,479,91,98,189
"2950",1852,1405,482,62,60,122
"2951",1944,1807,599,231,227,458
"2952",1635,1450,663,189,195,384
"2953",2126,1853,667,76,88,164
"2954",2139,1703,682,55,63,118
"2955",53,2041,732,92,96,188
"2956",24,2213,752,49,53,102
"2957",9,2026,1417,70,81,151
"2958",46,2330,1497,35,40,75
"2959",2230,2141,1533,32,36,68
"2960",1722,1400,1548,47,45,92
"2961",1138,1046,1583,75,81,156
"2962",2006,1915,1603,82,85,167
"2963",1324,1053,1646,31,33,64
"2964",2349,2227,1717,63,77,140
"2965",1752,1319,1832,92,89,181
"2966",1309,1129,52,214,224,438
"2967",142,2304,209,106,99,205
"2968",1735,1050,212,73,35,108
"2969",1539,1038,232,100,79,179
"2970",2256,1926,250,31,36,67
"2971",2348,2115,344,38,35,73
"2972",1233,820,404,65,45,110
"2973",1744,1250,432,143,130,273
"2974",2028,1548,532,153,143,296
"2975",1925,1619,606,38,34,72
"2976",2211,1725,632,103,87,190
"2977",122,2104,732,121,119,240
"2978",1857,1610,767,56,45,101
"2979",2235,1933,1506,36,39,75
"2980",1713,1349,1548,38,34,72
"2981",1820,1514,1562,45,49,94
"2982",57,2029,1632,164,164,328
"2983",21,2228,1644,74,88,162
"2984",2049,1619,1676,51,34,85
"2985",1844,1351,1832,144,121,265
"2986",1914,1739,1846,32,39,71
"2987",2032,1813,1889,35,38,73
"2988",2326,2140,299,50,35,85
"2989",1211,941,346,46,56,102
"2990",1435,1309,738,35,39,74
"2991",1910,1601,767,69,36,105
"2992",2044,1635,60,251,270,521
"2993",1200,859,706,87,94,181
"2994",1807,1628,795,41,48,89
"2995",1400,1242,197,45,52,97
"2996",1415,1146,270,35,36,71
"2997",2020,1901,397,72,76,148
"2998",2214,2018,489,79,103,182
"2999",1415,1256,499,47,71,118
"3000",2230,1949,567,45,49,94
"3001",2353,2000,732,32,55,87
"3002",1,2038,1492,71,83,154
"3003",2041,1736,1648,76,96,172
"3004",1943,1501,62,45,36,81
"3005",2350,2001,250,85,71,156
"3006",10,1939,310,39,39,78
"3007",1907,1404,532,72,39,111
"3008",2208,1905,570,108,75,183
"3009",1509,1333,601,36,33,69
"3010",2143,1716,632,75,78,153
"3011",2248,1946,670,90,51,141
"3012",1444,1137,686,61,67,128
"3013",200,2124,732,159,139,298
"3014",1901,1605,767,60,40,100
"3015",38,2226,770,96,96,192
"3016",2325,2140,820,42,50,92
"3017",13,2032,1417,74,87,161
"3018",1146,1014,1495,43,54,97
"3019",12,2118,1506,133,144,277
"3020",2229,2142,1533,31,37,68
"3021",48,2010,1632,149,145,294
"3022",1321,1058,1646,33,38,71
"3023",215,2312,1662,225,232,457
"3024",2238,1810,1676,160,145,305
"3025",2114,1723,1688,42,43,85
"3026",51,2327,1749,200,207,407
"3027",1727,1232,1832,58,39,97
"3028",1941,1840,5,49,52,101
"3029",2038,1913,59,83,93,176
"3030",1153,949,220,43,39,82
"3031",2008,1647,244,44,62,106
"3032",1943,1721,246,73,86,159
"3033",1501,1217,270,82,52,134
"3034",1222,935,346,62,50,112
"3035",1403,1230,352,61,65,126
"3036",2017,1858,397,57,58,115
"3037",2210,1947,444,37,47,84
"3038",1727,1341,458,44,46,90
"3039",1356,1223,499,41,33,74
"3040",2118,1939,520,99,114,213
"3041",1508,1223,546,38,38,76
"3042",8,1949,582,36,59,95
"3043",2316,2150,597,44,45,89
"3044",1942,1632,606,58,47,105
"3045",2312,1951,644,48,61,109
"3046",1412,1223,663,49,48,97
"3047",1539,1207,686,114,97,211
"3048",1916,1606,767,124,91,215
"3049",120,2307,770,134,127,261
"3050",1805,1425,786,84,55,139
"3051",2153,1832,1086,146,141,287
"3052",1734,1604,1589,73,67,140
"3053",1456,1256,1605,84,66,150
"3054",1434,1206,1646,104,106,210
"3055",1624,1428,1695,70,54,124
"3056",1034,804,1746,32,39,71
"3057",2303,1947,1748,42,50,92
"3058",1946,1545,1836,97,109,206
"3059",1416,1228,1882,47,48,95
"3060",2137,1931,1889,87,91,178
"3061",1721,1623,6,52,58,110
"3062",1719,1458,370,34,33,67
"3063",2005,1857,397,40,57,97
"3064",2305,2025,444,87,85,172
"3065",2043,1757,667,36,32,68
"3066",2209,1746,682,72,95,167
"3067",1128,813,1048,35,43,78
"3068",1227,1017,1407,52,62,114
"3069",2348,2246,1423,92,96,188
"3070",2340,2014,1488,34,59,93
"3071",1844,1528,1548,112,118,230
"3072",1328,1115,1646,33,55,88
"3073",2103,1712,1676,43,67,110
"3074",1429,1016,1,39,51,90
"3075",2033,1931,5,104,111,215
"3076",1658,1242,106,95,117,212
"3077",1716,1528,137,76,73,149
"3078",2333,2017,190,58,67,125
"3079",1747,1150,212,85,95,180
"3080",1356,1155,220,161,165,326
"3081",1612,1233,226,117,138,255
"3082",1630,1159,232,153,164,317
"3083",157,2236,250,198,216,414
"3084",1903,1738,275,105,115,220
"3085",1943,1829,297,153,164,317
"3086",2308,2137,299,33,32,65
"3087",1306,1035,309,98,100,198
"3088",106,2112,310,93,132,225
"3089",1605,1509,379,98,104,202
"3090",2011,1857,397,46,57,103
"3091",1536,1412,403,196,207,403
"3092",2304,2040,421,152,150,302
"3093",1654,1158,432,96,83,179
"3094",2127,2031,479,75,81,156
"3095",1819,1344,482,34,49,83
"3096",1356,1221,499,36,31,67
"3097",2323,2031,500,39,76,115
"3098",1637,1204,510,193,194,387
"3099",2059,1907,520,75,82,157
"3100",1605,1348,542,259,263,522
"3101",2313,2044,567,86,104,190
"3102",29,1956,582,52,66,118
"3103",1653,1533,599,53,68,121
"3104",1516,1400,601,36,53,89
"3105",2000,1709,606,71,84,155
"3106",2342,2106,616,95,111,206
"3107",1632,1534,623,48,59,107
"3108",2357,2021,658,63,82,145
"3109",1715,1559,697,70,84,154
"3110",2321,2058,709,191,200,391
"3111",105,2107,732,107,137,244
"3112",1331,1154,739,171,169,340
"3113",1605,1219,788,120,124,244
"3114",1525,1225,1006,87,95,182
"3115",2308,1840,1010,39,45,84
"3116",2317,2002,1027,51,62,113
"3117",1320,1011,1048,147,161,308
"3118",1750,1422,1088,35,52,87
"3119",1458,1224,1407,203,189,392
"3120",2223,2127,1441,132,132,264
"3121",1622,1306,1448,142,151,293
"3122",228,2227,1466,79,92,171
"3123",1644,1229,1476,129,129,258
"3124",21,2057,1488,75,102,177
"3125",58,2149,1492,126,154,280
"3126",15,2111,1506,138,141,279
"3127",2020,1839,1511,35,39,74
"3128",1712,1342,1544,178,192,370
"3129",1744,1436,1548,52,66,118
"3130",1342,1247,1583,202,207,409
"3131",2032,1936,1603,102,101,203
"3132",1418,1231,1605,43,41,84
"3133",1358,1135,1646,63,75,138
"3134",1157,1103,1679,95,103,198
"3135",2001,1827,1689,44,52,96
"3136",1518,1151,1690,74,81,155
"3137",1541,1353,1695,41,38,79
"3138",2203,2044,1711,90,94,184
"3139",1432,1215,1714,185,185,370
"3140",1430,1304,1723,199,214,413
"3141",1659,1404,1757,63,74,137
"3142",120,2323,1758,111,128,239
"3143",1605,1327,1767,231,237,468
"3144",1937,1842,1779,50,57,107
"3145",1511,1413,1823,213,228,441
"3146",1659,1234,1832,47,54,101
"3147",2104,1854,1858,62,74,136
"3148",1510,1154,1873,176,179,355
"3149",2207,1748,210,99,118,217
"3150",1815,1554,370,90,89,179
"3151",1635,1139,432,77,64,141
"3152",2223,1932,570,123,102,225
"3153",14,2135,670,160,150,310
"3154",43,2221,770,93,81,174
"3155",2100,1820,1070,150,140,290
"3156",2000,1825,1795,32,39,71
"3157",1324,1040,1590,62,78,140
"3158",957,700,1248,52,60,112
"3159",1003,658,2375,55,58,113
"3160",1640,1343,1540,39,43,82
"3161",1722,1417,1540,81,77,158
"3162",2142,1851,2095,32,50,82
"3163",1955,1646,8,61,51,112
"3164",1232,922,1248,207,202,409
"3165",1934,1642,8,40,47,87
"3166",1734,1446,1540,93,106,199
"3167",1925,1616,1540,204,196,400
"3168",1104,751,1248,119,111,230
"3169",1704,1416,4979,50,56,106
"3170",1704,1407,4979,50,47,97
"3171",1930,1554,5101,334,294,628
"3172",2256,2018,5183,111,133,244
"3173",2224,1942,5183,79,97,176
"3174",2250,2004,5183,105,119,224
"3175",2201,1916,5183,56,71,127
"3176",2154,1856,5183,49,51,100
"3177",2210,1929,5183,65,84,149
"3178",1443,1145,5186,32,33,65
"3179",1605,1312,5186,114,120,234
"3180",1456,1159,5186,45,47,92
"3181",1516,1208,5186,65,56,121
"3182",1446,1147,5186,35,35,70
"3183",1620,1220,5186,129,68,197
"3184",1533,1238,5186,82,86,168
"3185",1710,1418,5186,179,186,365
"3186",1315,1024,5189,33,38,71
"3187",1622,1327,5189,220,221,441
"3188",1327,1042,5189,45,56,101
"3189",1441,1123,5189,119,97,216
"3190",1514,1215,5189,152,149,301
"3191",1443,1204,5189,121,138,259
"3192",1946,1651,5190,43,46,89
"3193",2033,1736,5190,99,100,199
"3194",2157,1910,5190,183,194,377
"3195",1952,1655,5190,49,50,99
"3196",2003,1719,5190,69,83,152
"3197",2036,1749,5190,102,113,215
"3198",2000,1628,5525,90,108,198
"3199",2008,1628,5525,98,108,206
"3200",1952,1552,5525,82,72,154
"3201",1914,1538,5525,44,58,102
"3202",1911,1535,5525,41,55,96
"3203",1752,1633,145,42,44,86
"3204",1746,1632,145,36,43,79
"3205",1752,1624,145,42,35,77
"3206",1822,1655,145,72,66,138
"3207",1944,1803,145,154,134,288
"3208",1625,1324,286,79,73,152
"3209",1926,1628,288,89,83,172
"3210",2347,2101,296,87,91,178
"3211",2309,2024,286,483,493,976
"3212",2257,2001,296,37,31,68
"3213",2254,2010,296,34,40,74
"3214",1918,1550,288,72,34,106
"3215",1900,1608,288,63,63,126
"3216",1545,1250,286,45,44,89
"3217",2128,1826,292,48,41,89
"3218",2006,1905,2870,31,40,71
"3219",2014,1856,2870,39,31,70
"3220",2218,2109,2870,163,164,327
"3221",2015,1913,2870,40,48,88
"3222",1203,1056,2958,33,36,69
"3223",1217,1112,2958,47,52,99
"3224",1221,1113,2958,51,53,104
"3225",1105,1000,3210,75,80,155
"3226",1027,916,3210,37,36,73
"3227",1043,944,3210,53,64,117
"3228",1042,931,3210,52,51,103
"3229",1551,1440,3216,151,150,301
"3230",1404,1250,3216,44,40,84
"3231",1441,1307,3216,81,57,138
"3232",1441,1336,3216,81,86,167
"3233",1434,1320,3216,74,70,144
"3234",2126,2019,3328,36,39,75
"3235",2219,2107,3328,89,87,176
"3236",1656,1552,3390,51,57,108
"3237",2258,2034,3717,103,104,207
"3238",2238,1956,3717,83,66,149
"3239",2259,2050,3717,49,70,119
"3240",2246,2027,3717,36,47,83
"3241",2207,1931,3717,52,41,93
"3242",2219,1944,3717,64,54,118
"3243",2221,1956,3717,66,66,132
"3244",2309,1942,3717,114,52,166
"3245",1837,1605,3786,42,35,77
"3246",2015,1744,3786,140,134,274
"3247",1925,1630,3786,90,60,150
"3248",2021,1753,3786,146,143,289
"3249",2015,1739,3786,140,129,269
"3250",1430,1153,3796,60,48,108
"3251",1441,1221,3796,71,76,147
"3252",1523,1213,3796,113,68,181
"3253",1449,1231,3796,79,86,165
"3254",1501,1231,3796,91,86,177
"3255",1423,1208,3796,53,63,116
"3256",1416,1142,3796,46,37,83
"3257",1420,1200,3796,50,55,105
"3258",951,717,3859,36,37,73
"3259",949,728,3859,34,48,82
"3260",1149,944,1142,63,34,97
"3261",2258,2145,1150,47,45,92
"3262",2336,2244,1150,85,104,189
"3263",1958,1843,1151,53,56,109
"3264",2031,1913,1151,86,86,172
"3265",1858,1656,1152,87,81,168
"3266",2245,2010,1153,47,40,87
"3267",2251,2019,1153,53,49,102
"3268",2218,1949,1154,44,49,93
"3269",1554,1304,1155,111,99,210
"3270",1643,1527,1159,44,51,95
"3271",1745,1619,1159,106,103,209
"3272",1732,1439,1160,99,89,188
"3273",1758,1517,1160,125,127,252
"3274",2128,2016,1165,33,46,79
"3275",2131,2007,1165,36,37,73
"3276",1835,1640,1165,49,50,99
"3277",1844,1645,1170,78,75,153
"3278",1250,1126,1177,110,106,216
"3279",1822,1445,1178,86,95,181
"3280",21,2245,1179,97,95,192
"3281",1417,1229,1180,206,199,405
"3282",1540,1200,1190,99,95,194
"3283",1630,1404,1191,94,84,178
"3284",1157,1005,1193,61,60,121
"3285",2000,1850,1194,85,70,155
"3286",1918,1831,1194,43,51,94
"3287",1900,1539,1197,190,184,374
"3288",1049,1012,1198,63,62,125
"3289",1343,1141,1127,95,81,176
"3290",1343,1132,1127,90,72,162
"3291",50,2156,1124,131,156,287
"3292",1233,1130,1141,125,120,245
"3293",1913,1846,1145,55,71,126
"3294",1938,1834,1145,80,59,139
"3295",1316,957,1117,48,47,95
"3296",1939,1822,1128,44,42,86
"3297",2156,1940,4455,65,65,130
"3298",2204,1949,4455,73,74,147
"3299",1853,1553,1112,56,47,103
"3300",2213,2136,1113,49,46,95
"3301",2345,2222,1113,86,92,178
"3302",2236,2202,1113,72,72,144
"3303",2204,2125,1113,40,35,75
"3304",1505,1235,1116,82,75,157
"3305",2007,1628,1107,31,38,69
"3306",2339,2130,1102,31,35,66
"3307",2355,2136,1102,47,41,88
"3308",1229,1120,1122,128,130,258
"3309",1712,1450,4489,57,46,103
"3310",1734,1447,4489,79,43,122
"3311",1732,1531,4489,77,87,164
"3312",1704,1451,4489,49,47,96
"3313",1032,821,4640,90,106,196
"3314",1648,1348,5800,309,303,612
"3315",1255,957,5800,62,53,115
"3316",1249,947,5800,51,43,94
"3317",1824,1521,5801,43,36,79
"3318",1350,1149,5801,107,99,206
"3319",1856,1710,5801,69,73,142
"3320",1658,1452,5802,37,37,74
"3321",1336,942,5802,148,137,285
"3322",1336,1146,5803,139,104,243
"3323",1726,1513,5803,56,49,105
"3324",1814,1459,5809,45,49,94
"3325",1715,1354,5810,31,39,70
"3326",2014,1835,5810,59,35,94
"3327",1808,1636,5810,154,136,290
"3328",2153,2027,5810,158,147,305
"3329",2107,1939,5810,112,99,211
"3330",1630,1506,5810,56,46,102
"3331",2320,2152,5814,47,37,84
"3332",2252,2023,5816,106,88,194
"3333",2212,1957,5816,51,42,93
"3334",2204,1935,5816,58,40,98
"3335",2310,2038,5816,124,103,227
"3336",2356,2026,5820,38,46,84
"3337",2110,2014,5825,124,129,253
"3338",1652,1518,5825,61,53,114
"3339",1752,1602,5825,121,97,218
"3340",1745,1520,5826,47,50,97
"3341",1650,1524,5829,48,40,88
"3342",1504,1329,5832,281,269,550
"3343",20,2335,5835,34,35,69
"3344",132,41,5835,106,101,207
"3345",2140,1759,5836,112,119,231
"3346",1902,1738,5839,60,47,107
"3347",1440,1126,5840,47,51,98
"3348",1547,1205,5840,109,90,199
"3349",1350,1144,5841,57,49,106
"3350",1430,1234,5841,102,99,201
"3351",27,2142,5842,238,252,490
"3352",2136,1833,5842,37,33,70
"3353",1454,1255,5843,100,85,185
"3354",2028,1842,5845,49,37,86
"3355",2116,1918,5845,97,73,170
"3356",2105,1919,5845,86,74,160
"3357",1935,1730,5846,135,120,255
"3358",1937,1743,5846,137,133,270
"3359",2011,1715,5847,43,45,88
"3360",2010,1701,5847,42,31,73
"3361",2142,1821,5847,134,111,245
"3362",2012,1713,5847,44,43,87
"3363",817,634,6698,49,34,83
"3364",1143,1011,6726,53,71,124
"3365",1341,1151,6726,171,171,342
"3366",2337,1939,7037,51,44,95
"3367",2326,1933,7037,40,38,78
"3368",33,2046,7037,107,111,218
"3369",105,2123,7037,139,148,287
"3370",2339,2002,7037,53,67,120
"3371",2044,1822,230,49,62,111
"3372",2217,1940,230,132,130,262
"3373",1035,818,242,40,42,82
"3374",1835,1445,552,31,35,66
"3375",1300,1044,771,185,186,371
"3376",1219,1011,855,62,71,133
"3377",1239,1001,855,82,61,143
"3378",1401,1008,855,164,68,232
"3379",1953,1755,855,516,535,1051
"3380",1214,948,855,57,48,105
"3381",1240,936,855,83,36,119
"3382",1438,1228,855,205,212,417
"3383",2133,1812,959,39,37,76
"3384",2148,1819,959,54,44,98
"3385",2131,1813,959,37,38,75
"3386",1325,920,1696,174,130,304
"3387",2046,1714,1978,101,92,193
"3388",1720,1412,1697,110,122,232
"3389",2142,1832,959,42,57,99
"3390",1939,1614,1978,31,34,65
"3391",2150,1843,959,50,68,118
"3392",1213,1132,576,53,57,110
"3393",13,2034,45,83,99,182
"3394",2214,2133,51,54,63,117
"3395",2021,1925,50,51,55,106
"3396",2044,1952,52,49,52,101
"3397",2202,2043,2113,77,88,165
"3398",2303,2051,3720,43,61,104
"3399",2232,2012,3832,87,97,184
"3400",2247,2152,1610,97,102,199
"3401",2255,2138,1168,60,63,123
"3402",2325,2137,215,180,192,372
"3403",2327,2240,3428,57,65,122
"3404",924,839,201,44,49,93
"3405",1226,1056,5060,36,41,77
"3406",2325,2136,869,120,126,246
"3407",2215,2045,1796,40,45,85
"3408",1836,1733,44,36,33,69
"3409",2330,2237,56,155,157,312
"3410",1327,1206,5060,97,111,208
"3411",2001,1828,41,36,38,74
"3412",2253,2202,55,33,42,75
"3413",1035,930,3,35,35,70
"3414",1153,902,323,48,52,100
"3415",2347,2059,3358,47,49,96
"3416",1010,848,467,45,48,93
"3417",1258,1147,104,88,92,180
"3418",2205,2023,1673,90,93,183
"3419",1445,1353,28,45,53,98
"3420",1534,1441,32,34,41,75
"3421",1945,1848,40,165,168,333
"3422",2016,1923,50,46,53,99
"3423",108,14,55,168,174,342
"3424",1728,1624,1790,48,44,92
"3425",1450,1244,1945,50,69,119
"3426",1815,1552,2018,40,47,87
"3427",1843,1741,37,38,36,74
"3428",2038,1941,1590,33,36,69
"3429",1710,1606,2315,35,31,66
"3430",1702,1551,2578,87,96,183
"3431",1529,1333,2123,34,38,72
"3432",1610,1315,11,130,130,260
"3433",1751,1641,1704,31,36,67
"3434",2058,2021,1915,98,106,204
"3435",2020,1935,301,145,150,295
"3436",2129,2040,1229,34,40,74
"3437",1742,1651,2117,47,51,98
"3438",1946,1851,2340,51,51,102
"3439",1435,1340,2649,40,40,80
"3440",1633,1540,3099,38,40,78
"3441",1858,1732,2755,58,67,125
"3442",2135,2030,1206,175,175,350
"3443",1244,1104,3644,74,39,113
"3444",1909,1747,2158,34,37,71
"3445",1819,1501,240,64,56,120
"3446",2146,1837,2122,51,47,98
"3447",1847,1754,1543,37,39,76
"3448",1923,1836,2480,58,61,119
"3449",2,2012,45,72,77,149
"3450",1758,1701,40,58,61,119
"3451",1844,1747,44,44,47,91
"3452",1754,1628,29,89,93,182
"3453",1112,946,3829,47,51,98
"3454",2331,1923,1954,121,118,239
"3455",2108,1931,1673,33,41,74
"3456",1758,1706,42,33,36,69
"3457",1832,1734,44,32,34,66
"3458",2258,2203,55,38,43,81
"3459",1407,1247,15,62,72,134
"3460",1945,1801,1557,150,156,306
"3461",2021,1714,2907,61,64,125
"3462",1845,1743,37,40,38,78
"3463",2206,1818,39,36,53,89
"3464",2057,1902,215,32,37,69
"3465",2218,2131,709,33,31,64
"3466",2014,1924,50,44,54,98
"3467",1720,1626,1790,40,46,86
"3468",42,2140,49,87,90,177
"3469",1526,1423,2801,41,38,79
"3470",1800,1600,3474,35,35,70
"3471",1934,1821,1270,74,76,150
"3472",2228,2105,1796,53,65,118
"3473",1732,1629,38,67,59,126
"3474",2226,2132,60,31,32,63
"3475",1700,1532,29,35,37,72
"3476",2229,2102,41,184,192,376
"3477",1438,1339,19,68,69,137
"3478",2357,2231,1536,77,101,178
"3479",1901,1758,37,56,53,109
"3480",36,2038,39,186,193,379
"3481",2208,2015,869,43,45,88
"3482",1433,1136,11,33,31,64
"3483",1638,1513,2094,63,63,126
"3484",2234,2151,709,49,51,100
"3485",1735,1647,1773,150,147,297
"3486",2308,2122,1673,153,152,305
"3487",2253,2207,51,93,97,190
"3488",1435,1338,28,35,38,73
"3489",1745,1645,40,45,45,90
"3490",2351,2251,60,116,111,227
"3491",2330,2017,264,125,127,252
"3492",2350,2056,49,35,46,81
"3493",2305,2026,3720,45,36,81
"3494",2131,2032,1590,86,87,173
"3495",2141,2044,1610,31,34,65
"3496",1849,1732,559,84,87,171
"3497",2312,1909,39,102,104,206
"3498",2128,1942,215,63,77,140
"3499",2228,2030,869,63,60,123
"3500",1834,1633,3474,69,68,137
"3501",1635,1457,2094,60,47,107
"3502",2154,2111,51,34,41,75
"3503",1534,1436,32,34,36,70
"3504",1747,1654,40,47,54,101
"3505",2229,2137,56,94,97,191
"3506",4,2314,60,129,134,263
"3507",1910,1746,2068,80,86,166
"3508",1756,1641,559,31,36,67
"3509",856,704,648,31,34,65
"3510",1738,1608,1554,33,38,71
"3511",1555,1511,1729,95,101,196
"3512",2126,2033,2957,31,33,64
"3513",1841,1719,1869,36,44,80
"3514",1641,1522,1079,66,72,138
"3515",1810,1628,1877,35,53,88
"3516",1738,1551,1045,58,66,124
"3517",1930,1854,511,110,119,229
"3518",2322,2236,1565,82,81,163
"3519",2305,2217,60,70,77,147
"3520",2319,2030,43,109,120,229
"3521",2251,2205,757,31,40,71
"3522",1547,1436,876,37,41,78
"3523",2247,2203,1565,47,48,95
"3524",1705,1525,963,200,210,410
"3525",1653,1301,1106,88,91,179
"3526",1647,1332,1164,147,152,299
"3527",1457,1404,30,32,34,66
"3528",1934,1842,48,34,42,76
"3529",2027,1928,50,57,58,115
"3530",2340,2252,60,105,112,217
"3531",1808,1649,3675,38,49,87
"3532",1431,1302,19,31,37,68
"3533",2231,2100,51,31,35,66
"3534",1447,1348,1147,62,63,125
"3535",1028,927,3,33,32,65
"3536",1606,1509,27,41,44,85
"3537",2235,2140,854,45,50,95
"3538",1817,1714,1389,67,64,131
"3539",1429,1330,3243,39,40,79
"3540",1853,1735,1899,123,115,238
"3541",2324,2030,43,114,120,234
"3542",1728,1518,122,253,233,486
"3543",1814,1640,1752,59,75,134
"3544",46,2329,1655,306,314,620
"3545",2358,2100,49,38,50,88
"3546",1707,1355,502,132,135,267
"3547",1902,1651,33,32,46,78
"3548",1650,1432,1352,90,97,187
"3549",1242,1145,11,37,40,77
"3550",2243,2138,1179,93,88,181
"3551",2108,2014,1286,108,114,222
"3552",1426,1325,1639,66,65,131
"3553",1639,1518,741,44,43,87
"3554",2300,2107,215,75,77,152
"3555",2040,1846,1296,180,181,361
"3556",2217,2050,1930,32,40,72
"3557",333,2355,1919,343,365,708
"3558",1819,1726,42,44,56,100
"3559",1933,1836,46,63,66,129
"3560",2026,1930,50,56,60,116
"3561",2307,2217,55,47,57,104
"3562",2229,1941,43,59,71,130
"3563",1620,1449,122,185,204,389
"3564",2143,2047,1179,33,37,70
"3565",246,2302,37,326,357,683
"3566",1236,1129,708,41,64,105
"3567",2357,2058,1212,47,48,95
"3568",1642,1526,3654,37,46,83
"3569",1937,1854,41,52,59,111
"3570",2003,1909,50,33,39,72
"3571",1959,1914,906,39,54,93
"3572",1431,1126,9,41,51,92
"3573",110,2223,43,220,233,453
"3574",1422,1257,122,67,92,159
"3575",2009,1916,1286,49,56,105
"3576",1703,1604,1095,48,39,87
"3577",1706,1604,38,36,34,70
"3578",2252,2201,55,32,41,73
"3579",2158,2047,1401,38,37,75
"3580",2110,1954,1861,55,54,109
"3581",2017,1710,401,62,65,127
"3582",3,2146,806,53,56,109
"3583",1802,1700,464,137,140,277
"3584",2147,2048,1179,37,38,75
"3585",2028,1930,1286,68,70,138
"3586",2339,1919,37,139,134,273
"3587",2127,2013,681,117,133,250
"3588",2044,1948,602,104,103,207
"3589",1918,1614,31,43,39,82
"3590",2233,1837,1919,43,47,90
"3591",1813,1701,42,38,31,69
"3592",1836,1743,44,36,43,79
"3593",2020,1928,50,50,58,108
"3594",2258,2205,55,38,45,83
"3595",1746,1645,1389,36,35,71
"3596",2231,1932,43,61,62,123
"3597",2048,1943,1861,33,43,76
"3598",111,2218,1212,121,128,249
"3599",1804,1713,170,64,73,137
"3600",1759,1702,1925,179,182,361
"3601",2153,2103,2957,58,63,121
"3602",1616,1457,765,56,67,123
"3603",1831,1514,3416,46,49,95
"3604",2032,1928,2118,42,48,90
"3605",2147,2029,1221,82,89,171
"3606",1244,1051,463,64,61,125
"3607",2251,2040,437,76,85,161
"3608",2031,1938,2690,51,58,109
"3609",1955,1855,3449,90,90,180
"3610",1352,1257,3510,32,37,69
"3611",2203,2030,5008,53,55,108
"3612",1712,1523,1045,32,38,70
"3613",2237,2119,3365,62,69,131
"3614",2026,1923,1425,106,118,224
"3615",2305,2137,1930,80,87,167
"3616",1823,1727,42,48,57,105
"3617",2301,2206,175,71,76,147
"3618",2345,2201,2725,40,46,86
"3619",2040,1918,1655,60,63,123
"3620",1950,1648,401,35,43,78
"3621",2257,2040,1003,57,65,122
"3622",1323,1104,1287,118,124,242
"3623",1828,1731,35,53,56,109
"3624",2151,2058,1179,41,48,89
"3625",2033,1941,1286,73,81,154
"3626",1640,1530,741,45,55,100
"3627",39,2148,1212,89,98,187
"3628",2234,2151,1565,34,36,70
"3629",1329,1200,3056,54,60,114
"3630",1440,1259,963,55,64,119
"3631",1833,1741,42,58,71,129
"3632",2020,1927,50,50,57,107
"3633",2231,2138,60,36,38,74
"3634",1706,1401,23,31,36,67
"3635",2051,1943,1861,36,43,79
"3636",1632,1512,741,37,37,74
"3637",102,13,757,162,168,330
"3638",2356,2110,1212,46,60,106
"3639",1319,1028,1932,44,53,97
"3640",2233,2146,1377,48,51,99
"3641",1529,1430,30,64,60,124
"3642",2000,1905,42,145,155,300
"3643",1919,1824,46,49,54,103
"3644",1823,1704,3675,53,64,117
"3645",2215,1924,43,45,54,99
"3646",1108,945,1469,43,45,88
"3647",1931,1820,1214,51,60,111
"3648",2258,2206,757,38,41,79
"3649",921,811,1076,36,41,77
"3650",2359,2323,1565,119,128,247
"3651",45,2051,47,80,86,166
"3652",1751,1654,1389,41,44,85
"3653",120,2348,2725,135,153,288
"3654",30,1954,37,190,169,359
"3655",1437,1349,887,32,39,71
"3656",2226,2039,215,41,49,90
"3657",1456,1146,1164,36,46,82
"3658",2316,2143,1332,41,43,84
"3659",2051,1944,1861,36,44,80
"3660",2019,1902,1655,39,47,86
"3661",2352,2142,806,42,52,94
"3662",2225,2137,2539,35,47,82
"3663",1313,1141,708,78,76,154
"3664",2237,2050,215,52,60,112
"3665",1932,1819,1580,67,79,146
"3666",9,2030,47,44,65,109
"3667",1841,1749,42,66,79,145
"3668",2019,1927,50,49,57,106
"3669",1758,1659,1389,48,49,97
"3670",2236,1952,43,66,82,148
"3671",1634,1448,122,199,203,402
"3672",59,2321,2725,114,126,240
"3673",2319,2220,1040,194,195,389
"3674",2233,1857,3188,43,62,105
"3675",1958,1858,1465,118,118,236
"3676",1544,1441,1925,44,41,85
"3677",1555,1432,765,35,42,77
"3678",1550,1444,3688,40,34,74
"3679",1856,1547,3416,71,82,153
"3680",1426,1318,2739,51,58,109
"3681",2016,1926,3449,111,121,232
"3682",2106,2010,893,31,35,66
"3683",2222,1853,1919,32,63,95
"3684",1930,1840,18,45,45,90
"3685",7,2318,1377,142,143,285
"3686",1503,1415,28,63,75,138
"3687",1458,1407,30,33,37,70
"3688",1658,1610,36,63,70,133
"3689",1822,1735,42,47,65,112
"3690",2240,2145,60,45,45,90
"3691",1930,1806,3675,120,126,246
"3692",2312,2217,55,52,57,109
"3693",2240,2143,175,50,53,103
"3694",1749,1652,1389,39,42,81
"3695",1746,1638,1899,56,58,114
"3696",2106,1804,401,111,119,230
"3697",108,2245,1727,188,185,373
"3698",2126,2012,1214,166,172,338
"3699",23,2036,37,183,211,394
"3700",1741,1653,862,171,178,349
"3701",1646,1548,1251,36,33,69
"3702",2216,2029,215,31,39,70
"3703",1749,1636,3654,104,116,220
"3704",1647,1543,876,97,108,205
"3705",2100,2009,52,60,69,129
"3706",2129,2034,56,34,34,68
"3707",2157,2105,58,32,35,67
"3708",2258,2209,60,63,69,132
"3709",1731,1434,23,56,69,125
"3710",8,2314,55,108,114,222
"3711",2232,2021,1727,32,41,73
"3712",1533,1450,862,43,55,98
"3713",1643,1553,915,33,38,71
"3714",2102,1807,31,147,152,299
"3715",1444,1347,3243,54,57,111
"3716",2159,1858,401,164,173,337
"3717",1634,1542,464,49,62,111
"3718",2054,1942,1286,94,82,176
"3719",2349,1943,37,149,158,307
"3720",2038,1927,681,68,87,155
"3721",1826,1635,1296,46,50,96
"3722",2233,2153,1565,33,38,71
"3723",1135,1044,16,35,44,79
"3724",1651,1554,36,56,54,110
"3725",1814,1723,42,39,53,92
"3726",2150,2102,56,55,62,117
"3727",2233,2145,60,38,45,83
"3728",2347,2213,1332,72,73,145
"3729",2039,1944,906,79,84,163
"3730",2301,2204,854,71,74,145
"3731",2150,1845,401,155,160,315
"3732",1630,1525,464,45,45,90
"3733",2000,1855,876,290,300,590
"3734",35,2350,1565,155,155,310
"3735",1312,1148,3056,37,48,85
"3736",134,2146,47,129,141,270
"3737",1032,933,12,32,33,65
"3738",1355,1248,20,115,108,223
"3739",1720,1616,38,50,46,96
"3740",2106,2011,40,246,251,497
"3741",2152,2101,52,112,121,233
"3742",13,2318,56,198,198,396
"3743",237,145,60,282,285,567
"3744",2241,2056,51,41,31,72
"3745",2153,2104,906,153,164,317
"3746",1812,1715,1147,267,270,537
"3747",1212,1122,1204,127,142,269
"3748",103,9,55,163,169,332
"3749",2329,2237,854,99,107,206
"3750",1742,1636,1899,52,56,108
"3751",2205,1916,43,35,46,81
"3752",30,2337,776,100,132,232
"3753",1946,1824,1752,151,179,330
"3754",1605,1238,5,200,183,383
"3755",225,2329,49,185,199,384
"3756",2235,1937,401,200,212,412
"3757",1325,1010,931,160,160,320
"3758",1236,1138,11,31,33,64
"3759",2118,2029,1286,118,129,247
"3760",37,2237,1727,157,177,334
"3761",2224,1835,37,64,90,154
"3762",1933,1850,602,33,45,78
"3763",140,53,757,200,208,408
"3764",2239,2044,215,54,54,108
"3765",1833,1639,1296,53,54,107
"3766",2001,1622,31,86,47,133
"3767",1248,934,201,113,99,212
"3768",1729,1558,3654,84,78,162
"3769",2214,1907,2008,148,141,289
"3770",2047,1750,2008,61,64,125
"3771",2035,1740,2008,69,75,144
"3772",2304,2202,2009,32,42,74
"3773",1757,1450,2010,69,70,139
"3774",2006,1700,2010,198,200,398
"3775",1842,1530,2010,114,110,224
"3776",1755,1453,2010,72,78,150
"3777",1350,1257,2018,100,92,192
"3778",1254,1159,2018,44,34,78
"3779",1913,1759,2025,177,174,351
"3780",1716,1556,2025,90,81,171
"3781",1014,806,2026,51,46,97
"3782",956,805,2026,33,45,78
"3783",1235,852,2035,91,92,183
"3784",1555,1246,2036,156,151,307
"3785",1626,1307,2036,187,172,359
"3786",1540,1306,2041,82,76,158
"3787",1508,1242,2041,85,82,167
"3788",1530,1301,2041,102,101,203
"3789",2242,2111,2042,84,91,175
"3790",2207,2033,2042,49,53,102
"3791",2212,2037,2042,54,57,111
"3792",2310,2141,2042,112,121,233
"3793",2140,1818,2044,42,43,85
"3794",2220,1903,2044,82,88,170
"3795",2207,1842,2044,69,67,136
"3796",1916,1812,2047,41,32,73
"3797",1544,1425,2048,40,40,80
"3798",1556,1441,2048,52,56,108
"3799",2317,1948,2050,39,53,92
"3800",2336,2007,2050,58,72,130
"3801",206,2221,2050,208,206,414
"3802",2322,1947,2050,44,52,96
"3803",1040,853,2056,38,47,85
"3804",1232,1032,2056,150,146,296
"3805",2027,1919,2062,41,44,85
"3806",2255,2159,2062,189,204,393
"3807",1418,1112,2064,63,62,125
"3808",1356,1053,2064,41,43,84
"3809",1409,1055,2064,49,45,94
"3810",1559,1516,2065,44,46,90
"3811",1512,1259,2066,285,240,525
"3812",1104,949,2066,42,50,92
"3813",1150,1028,2066,83,89,172
"3814",1200,1058,2068,49,48,97
"3815",1733,1619,2069,57,53,110
"3816",1714,1610,2069,38,44,82
"3817",1740,1635,2069,64,69,133
"3818",2306,1941,2076,32,31,63
"3819",1104,949,2079,36,49,85
"3820",1722,1627,2081,50,56,106
"3821",1425,1314,2082,102,109,211
"3822",1809,1607,2087,43,37,80
"3823",1839,1641,2087,73,71,144
"3824",1711,1546,2097,92,86,178
"3825",1750,1422,2105,87,92,179
"3826",1855,1525,2105,152,155,307
"3827",1658,1332,2105,35,42,77
"3828",1827,1508,2114,53,53,106
"3829",1858,1535,2114,84,80,164
"3830",1918,1603,2114,104,108,212
"3831",1908,1541,2114,94,86,180
"3832",1949,1705,2122,56,50,106
"3833",2058,1816,2122,125,121,246
"3834",1953,1650,2122,60,35,95
"3835",2027,1751,2122,94,96,190
"3836",2110,1829,2122,137,134,271
"3837",2226,1931,2122,213,196,409
"3838",2325,2233,2131,66,73,139
"3839",2252,2200,2131,33,40,73
"3840",20,2323,2131,121,123,244
"3841",2317,2218,2131,58,58,116
"3842",1113,1005,2132,134,145,279
"3843",1835,1727,2133,31,38,69
"3844",1931,1822,2133,87,93,180
"3845",2006,1850,2133,122,121,243
"3846",2014,1848,2133,130,119,249
"3847",25,2055,2171,95,115,210
"3848",2322,1934,2171,32,34,66
"3849",1616,1416,2174,115,76,191
"3850",1511,1355,2174,45,55,100
"3851",1501,1343,2174,35,43,78
"3852",1048,1003,2183,33,43,76
"3853",1023,855,2189,82,55,137
"3854",1111,1016,2194,57,56,113
"3855",1841,1519,2198,68,64,132
"3856",1831,1513,2198,58,58,116
"3857",1806,1501,2198,33,46,79
"3858",1407,1250,2200,67,70,137
"3859",2111,2010,2212,142,140,282
"3860",1615,1442,2213,91,82,173
"3861",1639,1518,2213,111,118,229
"3862",1630,1513,2213,102,113,215
"3863",1553,1432,2213,65,72,137
"3864",1324,913,2240,155,113,268
"3865",1136,809,2240,42,49,91
"3866",1353,1207,2249,133,117,250
"3867",1407,1249,2253,78,79,157
"3868",1449,1328,2253,115,118,233
"3869",1443,1218,2253,109,48,157
"3870",1424,1307,2253,95,97,192
"3871",1349,1217,2253,60,52,112
"3872",940,846,2254,39,46,85
"3873",2248,2200,2261,35,40,75
"3874",2253,2210,2261,40,50,90
"3875",2246,2203,2261,33,43,76
"3876",34,2350,2261,141,150,291
"3877",2252,2206,2261,39,46,85
"3878",1937,1721,2262,127,116,243
"3879",1823,1603,2262,53,38,91
"3880",1553,1257,2266,134,137,271
"3881",1510,1119,2268,67,49,116
"3882",1503,1143,2268,65,78,143
"3883",1555,1243,2272,42,43,85
"3884",1906,1700,2274,144,136,280
"3885",2227,1913,2276,146,148,294
"3886",2237,1849,2276,156,124,280
"3887",2154,1853,2276,113,128,241
"3888",1423,1320,2277,106,112,218
"3889",1451,1238,2277,142,78,220
"3890",1953,1748,2278,138,138,276
"3891",2128,2007,2280,35,42,77
"3892",2135,2014,2280,42,49,91
"3893",2144,2022,2280,51,57,108
"3894",2135,2015,2280,47,55,102
"3895",1459,1332,2283,219,182,401
"3896",1358,1259,2283,143,134,277
"3897",2334,2019,2288,53,59,112
"3898",3,2043,2288,47,48,95
"3899",43,2142,2288,87,107,194
"3900",1418,1114,2295,34,39,73
"3901",2026,1702,2298,101,91,192
"3902",2034,1730,2298,105,115,220
"3903",2012,1705,2298,87,94,181
"3904",1251,1124,2301,48,54,102
"3905",1550,1415,2304,107,85,192
"3906",1747,1631,2308,89,76,165
"3907",1700,1553,2308,37,38,75
"3908",1657,1553,2308,39,43,82
"3909",1748,1637,2308,90,87,177
"3910",1815,1501,2317,36,46,82
"3911",1831,1451,2317,52,36,88
"3912",1848,1533,2317,69,78,147
"3913",1742,1421,2318,68,76,144
"3914",1835,1524,2334,77,69,146
"3915",1801,1504,2334,43,49,92
"3916",1649,1514,2336,39,42,81
"3917",1651,1519,2336,41,47,88
"3918",1653,1506,2336,43,34,77
"3919",1645,1513,2336,35,41,76
"3920",1715,1527,2336,70,60,130
"3921",1508,1159,2340,86,88,174
"3922",1825,1641,2346,34,31,65
"3923",1903,1656,2346,72,46,118
"3924",2110,1925,2346,199,195,394
"3925",2218,1920,2359,109,110,219
"3926",2118,1820,2359,49,50,99
"3927",2105,1805,2359,36,35,71
"3928",1140,1100,2373,190,200,390
"3929",2057,1914,2376,74,74,148
"3930",2042,1900,2376,59,60,119
"3931",2025,1844,2376,42,44,86
"3932",2101,1850,2381,73,70,143
"3933",2053,1849,2381,35,39,74
"3934",1615,1252,2386,141,142,283
"3935",1517,1152,2386,57,56,113
"3936",1530,1206,2386,70,70,140
"3937",1534,1216,2386,74,80,154
"3938",1436,1337,2399,47,47,94
"3939",1529,1429,2399,75,74,149
"3940",1451,1349,2399,37,34,71
"3941",1523,1351,2399,94,61,155
"3942",2051,1735,2405,210,200,410
"3943",1758,1453,2405,37,38,75
"3944",1807,1512,2405,46,57,103
"3945",1420,1326,2407,105,106,211
"3946",1515,1353,2407,160,133,293
"3947",2212,1933,2413,49,38,87
"3948",2103,2018,2418,40,48,88
"3949",2129,2047,2418,41,52,93
"3950",2216,2135,2418,88,100,188
"3951",2137,2055,2418,49,60,109
"3952",1400,1238,2421,89,68,157
"3953",2019,1908,2425,69,68,137
"3954",2035,1922,2425,75,72,147
"3955",2144,2039,2425,124,129,253
"3956",2044,1931,2425,94,91,185
"3957",1621,1453,2427,36,38,74
"3958",1359,1219,2429,54,44,98
"3959",1342,1213,2429,32,33,65
"3960",1209,831,2432,46,36,82
"3961",1222,856,2432,62,56,118
"3962",1259,909,2432,96,74,170
"3963",1401,1212,2433,67,42,109
"3964",1504,1220,2433,135,60,195
"3965",1335,1142,2434,126,92,218
"3966",1254,1124,2434,80,74,154
"3967",1717,1635,2442,46,60,106
"3968",1850,1747,2442,139,132,271
"3969",1726,1639,2442,45,54,99
"3970",142,49,2450,104,104,208
"3971",1854,1733,2465,43,48,91
"3972",2024,1852,2465,145,139,284
"3973",1838,1715,2465,39,42,81
"3974",930,834,2469,40,43,83
"3975",1000,857,2469,70,66,136
"3976",1208,859,2470,89,69,158
"3977",1409,1124,2470,194,198,392
"3978",1137,845,2470,58,55,113
"3979",1229,941,2470,110,111,221
"3980",1706,1400,2472,42,40,82
"3981",1840,1533,2472,76,68,144
"3982",1843,1703,2474,80,93,173
"3983",1848,1708,2474,85,98,183
"3984",1835,1636,2474,72,66,138
"3985",1143,842,2477,44,42,86
"3986",1139,842,2477,40,42,82
"3987",1729,1512,2479,63,57,120
"3988",1712,1455,2479,46,40,86
"3989",2112,2017,2481,41,47,88
"3990",2106,2013,2481,43,48,91
"3991",2129,2028,2481,66,63,129
"3992",1249,1131,2482,63,61,124
"3993",2110,1734,2488,77,59,136
"3994",2038,1713,2488,40,33,73
"3995",2055,1735,2488,62,60,122
"3996",1526,1426,2489,67,61,128
"3997",2019,1657,2492,65,77,142
"3998",2150,1825,2492,156,165,321
"3999",2215,1839,2492,181,179,360
"4000",1847,1709,2497,83,88,171
"4001",1824,1645,2497,66,70,136
"4002",1645,1524,2499,146,129,275
"4003",1450,1348,2499,31,33,64
"4004",1346,1226,2501,87,66,153
"4005",1255,1159,2501,36,39,75
"4006",2335,2232,2515,71,72,143
"4007",143,46,2515,199,206,405
"4008",1,2302,2515,97,102,199
"4009",1146,812,2516,33,47,80
"4010",1722,1411,2520,188,192,380
"4011",1654,1211,2520,160,72,232
"4012",1327,1124,2522,73,74,147
"4013",915,753,2525,47,33,80
"4014",1023,855,2525,100,80,180
"4015",1411,1111,2528,111,55,166
"4016",1816,1507,2529,135,127,262
"4017",1251,1158,2534,85,93,178
"4018",32,2236,2534,83,81,164
"4019",1715,1552,2548,47,47,94
"4020",1927,1607,2550,118,112,230
"4021",1326,1235,2559,180,185,365
"4022",1208,1120,2559,87,95,182
"4023",1933,1840,2562,62,70,132
"4024",2014,1915,2562,103,105,208
"4025",1951,1834,2562,80,64,144
"4026",1920,1815,2562,49,45,94
"4027",1940,1848,2562,69,78,147
"4028",1946,1850,2562,75,80,155
"4029",2118,2020,2570,50,55,105
"4030",1745,1442,2572,32,47,79
"4031",1818,1506,2572,65,71,136
"4032",1321,1123,2573,247,243,490
"4033",1438,1133,2576,144,58,202
"4034",1253,1121,2576,39,46,85
"4035",1649,1556,2581,86,91,177
"4036",1805,1715,2581,167,175,342
"4037",1759,1653,2581,161,153,314
"4038",1557,1505,2581,39,45,84
"4039",1700,1608,2591,109,118,227
"4040",1548,1448,2591,37,38,75
"4041",1637,1536,2591,81,81,162
"4042",1642,1547,2591,91,97,188
"4043",1631,1540,2591,80,90,170
"4044",1611,1509,2591,60,59,119
"4045",1641,1405,2593,92,65,157
"4046",1544,1340,2593,35,40,75
"4047",1606,1338,2593,57,38,95
"4048",1733,1516,2593,144,136,280
"4049",2003,1831,2594,91,82,173
"4050",1921,1804,2594,49,55,104
"4051",1907,1751,2594,35,42,77
"4052",1926,1809,2594,54,60,114
"4053",1950,1834,2594,78,85,163
"4054",2004,1847,2594,92,98,190
"4055",9,2104,2597,78,79,157
"4056",46,2142,2597,115,117,232
"4057",2330,2035,2597,54,65,119
"4058",2017,1828,2598,48,53,101
"4059",2035,1847,2598,66,72,138
"4060",1614,1447,2600,70,68,138
"4061",1625,1445,2600,81,66,147
"4062",1549,1434,2600,33,43,76
"4063",1656,1538,2600,112,119,231
"4064",1717,1540,2601,53,54,107
"4065",1549,1516,2601,46,51,97
"4066",937,751,2606,44,31,75
"4067",1424,1115,2618,170,166,336
"4068",1247,942,2618,73,73,146
"4069",1508,1203,2622,100,103,203
"4070",1827,1719,2625,120,115,235
"4071",1820,1713,2625,113,109,222
"4072",1723,1621,2625,62,63,125
"4073",1632,1328,2629,53,53,106
"4074",1830,1515,2629,131,120,251
"4075",1724,1632,2631,109,111,220
"4076",1715,1625,2631,105,104,209
"4077",1651,1555,2631,78,76,154
"4078",2146,2027,2637,61,72,133
"4079",2129,2017,2637,44,62,106
"4080",1828,1524,2642,52,44,96
"4081",1843,1537,2642,72,57,129
"4082",1910,1613,2642,94,93,187
"4083",1946,1641,2642,130,121,251
"4084",1810,1511,2642,34,31,65
"4085",1831,1531,2642,55,51,106
"4086",1959,1839,2647,80,63,143
"4087",1131,1027,2649,49,60,109
"4088",2206,2020,2651,43,55,98
"4089",2241,2048,2651,78,83,161
"4090",2204,2012,2651,41,47,88
"4091",2158,2003,2651,35,38,73
"4092",2204,2012,2651,41,47,88
"4093",2331,2145,2651,128,140,268
"4094",1904,1547,2652,301,302,603
"4095",1616,1303,2652,123,128,251
"4096",1945,1852,2656,37,47,84
"4097",1545,1109,2668,137,49,186
"4098",1713,1413,2668,230,233,463
"4099",1601,1245,2671,57,50,107
"4100",1610,1242,2671,71,47,118
"4101",1548,1241,2671,49,46,95
"4102",1700,1234,2671,116,39,155
"4103",1557,1246,2671,58,51,109
"4104",2052,1939,2675,137,129,266
"4105",1927,1825,2675,52,55,107
"4106",2014,1916,2675,99,106,205
"4107",1941,1835,2675,66,65,131
"4108",122,2251,2680,97,101,198
"4109",1551,1504,2681,89,97,186
"4110",1505,1411,2681,43,44,87
"4111",1557,1445,2681,95,78,173
"4112",1529,1431,2681,64,61,125
"4113",959,842,2687,66,72,138
"4114",2333,2241,2692,74,76,150
"4115",1823,1626,2695,74,56,130
"4116",1900,1731,2695,96,106,202
"4117",1920,1811,2705,49,51,100
"4118",1856,1746,2705,77,78,155
"4119",1835,1724,2705,60,55,115
"4120",108,2223,2708,60,68,128
"4121",1753,1449,2715,59,64,123
"4122",1804,1505,2715,70,80,150
"4123",1751,1428,2715,57,43,100
"4124",1747,1441,2715,53,56,109
"4125",2058,1800,2728,90,90,180
"4126",2153,1856,2728,145,146,291
"4127",2117,1821,2728,109,111,220
"4128",1945,1649,2728,47,49,96
"4129",2043,1953,2731,48,53,101
"4130",2039,1953,2731,44,53,97
"4131",1212,1047,2734,43,37,80
"4132",1348,1047,2736,39,37,76
"4133",1352,1053,2736,43,43,86
"4134",1907,1748,2748,45,44,89
"4135",1912,1747,2748,50,43,93
"4136",2051,1938,2748,149,154,303
"4137",1237,1049,2750,41,31,72
"4138",1354,1206,2750,116,111,227
"4139",1731,1637,2755,98,102,200
"4140",1745,1703,2755,112,128,240
"4141",1638,1539,2755,45,44,89
"4142",1541,1446,2769,58,61,119
"4143",1840,1741,2769,234,233,467
"4144",1601,1439,2773,56,37,93
"4145",1603,1435,2773,55,35,90
"4146",1924,1805,2778,191,185,376
"4147",1738,1621,2778,93,96,189
"4148",1644,1533,2778,31,33,64
"4149",1652,1542,2778,39,42,81
"4150",1744,1404,2780,39,37,76
"4151",1813,1425,2780,65,60,125
"4152",2356,2107,2782,58,67,125
"4153",2335,2040,2782,47,50,97
"4154",2351,2107,2782,53,67,120
"4155",2332,2045,2782,34,45,79
"4156",1659,1334,2791,51,39,90
"4157",1712,1406,2791,64,71,135
"4158",1748,1537,2793,145,127,272
"4159",1617,1424,2793,57,57,114
"4160",1608,1407,2793,53,40,93
"4161",1630,1436,2793,67,66,133
"4162",2004,1709,2796,55,58,113
"4163",1126,956,2799,46,56,102
"4164",2210,2043,2800,70,73,143
"4165",2330,2156,2800,150,146,296
"4166",2138,2019,2800,38,49,87
"4167",2312,2222,2803,69,72,141
"4168",2135,2014,2804,40,49,89
"4169",2154,2017,2804,59,52,111
"4170",1722,1637,2809,49,62,111
"4171",1720,1630,2809,47,55,102
"4172",1717,1618,2809,44,43,87
"4173",1717,1620,2809,39,40,79
"4174",1553,1409,2811,105,79,184
"4175",1350,1246,2817,74,76,150
"4176",2344,2049,2822,48,59,107
"4177",19,2102,2822,83,72,155
"4178",2358,2110,2822,62,80,142
"4179",31,2332,2823,32,32,64
"4180",151,45,2823,112,105,217
"4181",1713,1514,2824,160,139,299
"4182",1432,1128,2833,156,45,201
"4183",1240,1128,2833,44,45,89
"4184",2147,2042,2834,209,217,426
"4185",1843,1720,2840,44,47,91
"4186",1925,1751,2840,91,78,169
"4187",1956,1840,2840,117,127,244
"4188",1909,1741,2840,65,63,128
"4189",2224,2059,2840,260,261,521
"4190",1753,1434,2841,103,104,207
"4191",1814,1453,2841,124,123,247
"4192",1701,1347,2841,51,57,108
"4193",1756,1439,2841,106,109,215
"4194",1612,1414,2844,104,79,183
"4195",1553,1425,2844,85,90,175
"4196",1533,1401,2844,65,66,131
"4197",2119,1939,2873,76,79,155
"4198",2036,1851,2873,33,31,64
"4199",2027,1852,2873,49,52,101
"4200",1555,1412,2881,85,87,172
"4201",2117,1925,2882,116,115,231
"4202",2055,1915,2882,94,105,199
"4203",2006,1822,2882,45,52,97
"4204",2022,1834,2882,61,64,125
"4205",2113,1919,2882,112,109,221
"4206",40,2059,2883,92,89,181
"4207",34,2057,2883,86,87,173
"4208",2350,2036,2883,42,66,108
"4209",101,2140,2883,113,130,243
"4210",15,2033,2883,67,63,130
"4211",1726,1346,2890,48,56,104
"4212",1531,1348,2895,180,138,318
"4213",1318,1205,2895,47,35,82
"4214",2031,1930,2902,113,110,223
"4215",1932,1847,2902,54,67,121
"4216",2041,1948,2902,123,128,251
"4217",2055,2003,2907,32,38,70
"4218",2136,2048,2907,73,83,156
"4219",2109,2024,2907,51,59,110
"4220",2104,2020,2907,41,55,96
"4221",1537,1147,2916,259,157,416
"4222",1250,1037,2916,114,102,216
"4223",1202,1002,2916,64,67,131
"4224",1350,1132,2916,172,157,329
"4225",2020,1900,2920,148,153,301
"4226",2205,2033,2920,253,246,499
"4227",1831,1720,2920,39,53,92
"4228",1432,1221,2924,54,46,100
"4229",1308,1116,2928,94,66,160
"4230",1912,1810,2936,143,137,280
"4231",1731,1648,2936,42,55,97
"4232",1808,1716,2936,79,83,162
"4233",1735,1628,2936,69,53,122
"4234",1727,1636,2936,56,61,117
"4235",1757,1710,2936,86,95,181
"4236",1724,1630,2936,35,37,72
"4237",2231,2052,2938,52,52,104
"4238",2246,2107,2938,67,67,134
"4239",2259,2119,2938,80,79,159
"4240",242,110,2938,288,295,583
"4241",1857,1733,2944,111,123,234
"4242",1850,1723,2944,51,58,109
"4243",1853,1721,2944,41,43,84
"4244",2107,1931,2945,92,96,188
"4245",2014,1837,2945,39,42,81
"4246",2113,1927,2945,103,97,200
"4247",2006,1836,2945,31,41,72
"4248",2033,1907,2945,58,72,130
"4249",1943,1720,2948,83,93,176
"4250",1932,1707,2948,72,80,152
"4251",2009,1740,2948,104,108,212
"4252",1913,1645,2948,48,53,101
"4253",1936,1725,2948,76,98,174
"4254",1902,1636,2948,42,49,91
"4255",2207,2058,2954,87,93,180
"4256",2146,2022,2954,61,57,118
"4257",2210,2052,2954,85,87,172
"4258",2141,2021,2954,56,56,112
"4259",2149,2038,2954,64,73,137
"4260",3,2207,2976,54,52,106
"4261",11,2219,2976,62,64,126
"4262",2208,2021,2976,49,56,105
"4263",32,2309,2978,101,104,205
"4264",910,810,2994,49,45,94
"4265",1302,1144,2996,71,74,145
"4266",1517,1332,2998,44,32,76
"4267",1553,1358,2998,80,58,138
"4268",1524,1357,2998,51,57,108
"4269",1352,1203,3002,107,103,210
"4270",1334,1141,3002,84,81,165
"4271",1604,1416,3002,224,226,450
"4272",1631,1352,3004,53,47,100
"4273",1914,1820,3005,46,45,91
"4274",1932,1846,3005,59,71,130
"4275",1941,1835,3005,68,60,128
"4276",1441,1042,3008,35,32,67
"4277",1638,1236,3008,153,146,299
"4278",2210,2043,3016,39,43,82
"4279",2310,2138,3016,107,113,220
"4280",2228,2047,3016,57,47,104
"4281",2205,2046,3016,34,46,80
"4282",2232,2104,3016,61,64,125
"4283",2218,2058,3016,47,58,105
"4284",2203,2053,3022,62,68,130
"4285",2144,2039,3022,43,54,97
"4286",2139,2019,3022,38,34,72
"4287",2140,2035,3022,39,50,89
"4288",2100,1955,3027,102,105,207
"4289",2010,1904,3027,52,54,106
"4290",2020,1920,3027,62,70,132
"4291",1953,1856,3027,35,46,81
"4292",1153,828,3032,58,56,114
"4293",1155,838,3032,60,66,126
"4294",1701,1528,3033,63,68,131
"4295",1653,1507,3033,50,42,92
"4296",1704,1526,3033,66,66,132
"4297",1637,1456,3033,39,36,75
"4298",1754,1603,3033,116,103,219
"4299",51,2141,3036,91,90,181
"4300",54,2145,3036,94,94,188
"4301",20,2114,3036,60,63,123
"4302",15,2104,3036,55,53,108
"4303",25,2113,3036,65,62,127
"4304",2226,2031,3038,56,56,112
"4305",2250,2104,3038,80,89,169
"4306",2204,2017,3038,34,42,76
"4307",2227,2038,3038,57,63,120
"4308",2337,2157,3038,127,142,269
"4309",2326,2143,3038,116,128,244
"4310",2245,2053,3038,75,78,153
"4311",1034,855,3040,53,48,101
"4312",1049,915,3040,68,68,136
"4313",1026,849,3040,45,42,87
"4314",2318,2019,3050,45,47,92
"4315",2259,2007,3050,58,67,125
"4316",2258,2006,3050,57,66,123
"4317",2242,1940,3050,41,40,81
"4318",1352,1138,3060,139,83,222
"4319",1333,1202,3060,115,102,217
"4320",2335,2023,3076,56,63,119
"4321",1832,1436,3078,64,46,110
"4322",1823,1451,3078,55,61,116
"4323",2028,1630,3078,176,151,327
"4324",1935,1552,3078,118,113,231
"4325",1817,1438,3078,49,48,97
"4326",1257,1029,3083,159,164,323
"4327",1430,1235,3092,42,40,82
"4328",1707,1329,3100,238,199,437
"4329",1525,1142,3101,81,68,149
"4330",1726,1402,3101,207,208,415
"4331",2040,1906,3102,46,41,87
"4332",2202,2039,3105,72,69,141
"4333",2201,2043,3105,71,73,144
"4334",2125,2014,3105,35,44,79
"4335",2317,2218,3111,59,63,122
"4336",2255,2149,3111,37,34,71
"4337",1824,1516,3117,85,91,176
"4338",1816,1508,3117,77,83,160
"4339",1227,1118,3119,44,53,97
"4340",1230,1115,3119,47,50,97
"4341",1623,1504,3120,132,134,266
"4342",2055,1956,3123,36,41,77
"4343",2135,2042,3123,76,87,163
"4344",2017,1845,3127,33,40,73
"4345",2100,1916,3127,76,71,147
"4346",2214,2041,3127,150,156,306
"4347",2344,2044,3128,106,109,215
"4348",46,2151,3137,107,126,233
"4349",21,2118,3137,82,93,175
"4350",226,2330,3137,207,225,432
"4351",1817,1626,3150,37,41,78
"4352",1902,1705,3150,82,80,162
"4353",1812,1610,3150,47,40,87
"4354",1357,1217,3152,61,57,118
"4355",1406,1217,3152,63,52,115
"4356",2305,2209,426,110,124,234
"4357",3,2304,426,168,179,347
"4358",2215,2103,426,60,58,118
"4359",2236,2123,426,81,78,159
"4360",1323,1135,493,193,160,353
"4361",2231,2133,653,61,73,134
"4362",949,741,1225,89,31,120
"4363",2153,1846,1294,43,56,99
"4364",2144,1827,1294,34,42,76
"4365",21,2117,1294,191,212,403
"4366",2309,2008,1294,119,143,262
"4367",1445,1306,1505,80,56,136
"4368",1556,1449,1566,46,49,95
"4369",1612,1458,1566,62,58,120
"4370",1803,1543,1566,173,103,276
"4371",1608,1458,1566,58,58,116
"4372",1415,1257,1698,55,52,107
"4373",1352,1245,1698,32,40,72
"4374",1849,1746,1925,69,76,145
"4375",1932,1802,1925,112,92,204
"4376",2142,2023,1925,242,233,475
"4377",1824,1719,1925,44,49,93
"4378",1949,1843,1925,129,133,262
"4379",2240,2012,731,90,102,192
"4380",2238,1936,731,92,66,158
"4381",2048,1615,624,42,40,82
"4382",2151,1624,624,110,53,163
"4383",1237,813,620,76,73,149
"4384",1306,849,620,105,109,214
"4385",2104,1618,624,63,47,110
"4386",1419,1247,499,74,62,136
"4387",2052,1810,667,57,40,97
"4388",1419,1107,1,84,92,176
"4389",1753,1344,60,70,104,174
"4390",1534,1405,173,43,50,93
"4391",1430,1343,241,42,43,85
"4392",2120,2003,397,120,123,243
"4393",1450,1140,686,63,75,138
"4394",58,2202,755,108,122,230
"4395",11,2206,1481,68,71,139
"4396",1734,1335,1790,71,35,106
"4397",1805,1358,1836,70,88,158
"4398",1741,1307,60,58,67,125
"4399",2024,1630,62,75,125,200
"4400",1700,1533,137,65,73,138
"4401",1528,1036,232,89,76,165
"4402",1227,811,240,42,46,88
"4403",1616,1136,382,41,46,87
"4404",205,2200,410,45,65,110
"4405",2140,1806,412,50,66,116
"4406",1904,1438,432,218,233,451
"4407",2358,2229,442,77,74,151
"4408",2201,2101,479,50,46,96
"4409",1945,1502,482,110,117,227
"4410",149,43,511,208,213,421
"4411",2030,1605,532,165,175,340
"4412",1304,1046,542,54,51,105
"4413",27,2018,582,44,83,127
"4414",2130,1718,632,55,83,138
"4415",2,2029,658,66,89,155
"4416",2352,1921,682,197,216,413
"4417",141,2127,732,131,152,283
"4418",1853,1439,810,63,89,152
"4419",1428,1122,1448,34,57,91
"4420",142,2249,1506,109,124,233
"4421",13,2325,1533,137,140,277
"4422",1846,1506,1562,154,121,275
"4423",234,2337,1586,265,287,552
"4424",49,2330,1597,125,135,260
"4425",1304,1219,1620,35,39,74
"4426",2127,1814,1648,135,149,284
"4427",101,2201,1662,152,166,318
"4428",2225,1835,1676,113,155,268
"4429",2003,1857,1779,51,42,93
"4430",1801,1615,1821,97,85,182
"4431",1826,1425,1836,91,115,206
"4432",2041,1835,1889,51,50,101
"4433",1700,1510,137,65,50,115
"4434",1940,1518,158,55,33,88
"4435",1218,921,309,68,31,99
"4436",141,2240,467,124,95,219
"4437",2121,1622,682,46,37,83
"4438",2356,2132,770,46,32,78
"4439",2320,1823,1540,51,33,84
"4440",2356,2229,1597,72,74,146
"4441",1124,831,1755,66,71,137
"4442",1704,1334,1790,41,34,75
"4443",1653,1513,137,58,53,111
"4444",1501,1404,241,73,64,137
"4445",1940,1644,246,90,74,164
"4446",2333,2135,299,73,40,113
"4447",1308,849,332,43,59,102
"4448",1225,1007,346,62,82,144
"4449",2142,1731,412,52,31,83
"4450",2356,2057,444,123,102,225
"4451",126,2141,467,109,36,145
"4452",1133,1011,497,59,56,115
"4453",47,1930,582,64,35,99
"4454",2156,1814,667,121,44,165
"4455",1825,1523,746,80,53,133
"4456",1922,1440,810,92,90,182
"4457",2258,2136,820,79,41,120
"4458",48,2204,1427,60,54,114
"4459",1953,1713,1546,46,43,89
"4460",2250,1934,1586,41,44,85
"4461",1959,1905,1603,59,55,114
"4462",2340,2146,1717,66,36,102
"4463",1052,807,1746,49,42,91
"4464",2210,1937,1889,140,112,252
"4465",1928,1813,5,41,33,74
"4466",2054,1853,150,88,58,146
"4467",2233,2141,227,37,36,73
"4468",1559,1116,232,120,116,236
"4469",1501,1219,270,91,54,145
"4470",2351,2212,299,91,77,168
"4471",1359,847,332,94,57,151
"4472",217,2203,410,57,68,125
"4473",2140,2028,417,75,88,163
"4474",11,2013,426,32,48,80
"4475",1729,1226,432,123,101,224
"4476",2310,2007,444,77,52,129
"4477",1933,1806,520,79,36,115
"4478",2013,1520,532,148,130,278
"4479",2324,2028,567,85,63,148
"4480",2323,1835,632,168,160,328
"4481",2201,1911,667,126,101,227
"4482",39,1949,732,69,54,123
"4483",114,2226,755,124,146,270
"4484",1909,1536,786,146,131,277
"4485",2327,2145,815,41,35,76
"4486",2219,2131,820,40,36,76
"4487",2312,2209,1423,57,59,116
"4488",2236,2148,1441,139,143,282
"4489",2337,2041,1506,99,111,210
"4490",2048,1658,1536,93,63,156
"4491",2324,1815,1632,76,45,121
"4492",1859,1658,1787,112,63,175
"4493",1825,1336,1832,133,121,254
"4494",2145,1820,1889,115,35,150
"4495",2027,1828,150,61,33,94
"4496",1847,1624,246,37,54,91
"4497",2108,1931,297,53,36,89
"4498",2337,2139,299,77,44,121
"4499",15,2151,442,94,36,130
"4500",37,2153,770,87,53,140
"4501",1200,954,872,36,39,75
"4502",2029,1839,1511,60,44,104
"4503",1443,1121,1544,55,71,126
"4504",2242,1831,1558,41,31,72
"4505",1928,1515,1844,68,40,108
"4506",1901,1537,1888,133,157,290
"4507",1944,1817,59,35,37,72
"4508",2037,1557,62,87,83,170
"4509",2306,2215,297,118,145,263
"4510",2259,1840,1540,38,50,88
"4511",1928,1703,1750,80,63,143
"4512",1855,1434,1836,120,124,244
"4513",1638,1354,146,50,39,89
"4514",1919,1601,281,69,31,100
"4515",34,2127,344,86,57,143
"4516",2228,2112,423,100,92,192
"4517",2335,2030,444,102,75,177
"4518",1624,1324,546,126,99,225
"4519",2108,1633,682,33,48,81
"4520",1624,1502,697,36,32,68
"4521",1504,1141,1646,131,81,212
"4522",2324,2023,1662,55,68,123
"4523",3,2005,1776,33,55,88
"4524",111,2248,209,73,73,146
"4525",1448,1213,267,43,38,81
"4526",1410,1205,270,40,40,80
"4527",1727,1526,303,53,61,114
"4528",1441,1344,379,37,34,71
"4529",159,2204,410,39,69,108
"4530",14,2132,770,64,32,96
"4531",2125,2038,1441,68,73,141
"4532",1036,929,1623,33,34,67
"4533",1956,1628,1648,44,43,87
"4534",1203,1103,1679,98,98,196
"4535",1756,1328,1836,61,58,119
"4536",2253,2023,444,60,68,128
"4537",2327,2222,511,66,72,138
"4538",1956,1526,532,131,136,267
"4539",1501,1236,546,43,51,94
"4540",2154,1710,682,79,85,164
"4541",20,1943,732,50,48,98
"4542",34,2217,752,62,57,119
"4543",47,2352,1479,166,167,333
"4544",2323,1826,1632,75,56,131
"4545",2022,1906,1705,68,66,134
"4546",1803,1334,1832,111,119,230
"4547",202,2327,209,124,112,236
"4548",2018,1637,244,48,52,100
"4549",2355,2228,299,95,93,188
"4550",2317,2150,442,36,35,71
"4551",28,2148,444,155,153,308
"4552",2104,1842,570,55,47,102
"4553",121,2252,1427,93,102,195
"4554",2329,2035,1506,91,105,196
"4555",2054,1912,1511,85,77,162
"4556",2306,1835,1540,37,45,82
"4557",2200,1904,1546,173,154,327
"4558",1702,1540,1589,42,40,82
"4559",2300,1812,1632,52,42,94
"4560",1355,1126,1646,62,66,128
"4561",2034,1823,1750,143,143,286
"4562",2149,1926,1889,119,101,220
"4563",1851,1733,275,91,103,194
"4564",1237,833,776,52,68,120
"4565",1720,1409,786,37,44,81
"4566",2321,2148,815,35,38,73
"4567",1932,1845,1603,32,35,67
"4568",1441,1305,1605,79,75,154
"4569",1050,756,1746,47,31,78
"4570",2028,1802,246,138,152,290
"4571",1529,1426,323,77,81,158
"4572",2231,2108,423,56,38,94
"4573",1615,1518,623,46,56,102
"4574",7,2146,770,57,46,103
"4575",1739,1416,1548,58,61,119
"4576",40,2104,1602,88,109,197
"4577",2307,1829,1632,59,59,118
"4578",1728,1342,1888,40,42,82
"4579",957,827,52,43,42,85
"4580",1624,1120,106,63,35,98
"4581",1351,1235,197,40,39,79
"4582",2335,2214,299,78,79,157
"4583",23,1955,310,52,55,107
"4584",2027,1916,397,70,76,146
"4585",114,2208,467,90,53,143
"4586",1425,1149,542,138,114,252
"4587",40,2224,877,55,74,129
"4588",2316,1850,1540,55,60,115
"4589",2315,2202,1597,34,47,81
"4590",1452,1323,1605,93,93,186
"4591",4,1948,1776,37,38,75
"4592",2000,1815,59,48,35,83
"4593",1635,1452,137,40,32,72
"4594",1437,1232,270,67,67,134
"4595",2131,1736,412,37,32,69
"4596",30,2030,426,51,65,116
"4597",2311,1954,444,78,39,117
"4598",157,2256,467,140,111,251
"4599",1435,930,510,54,35,89
"4600",1431,1112,686,44,47,91
"4601",2244,1924,1546,217,174,391
"4602",133,2341,1644,138,146,284
"4603",2319,2009,1748,41,59,100
"4604",1838,1716,1787,91,81,172
"4605",1643,1512,137,48,52,100
"4606",1350,1223,197,45,33,78
"4607",252,2331,467,195,146,341
"4608",2323,2216,511,62,66,128
"4609",1153,804,544,81,79,160
"4610",1148,1019,559,53,59,112
"4611",1924,1635,606,40,55,95
"4612",2237,1955,616,38,45,83
"4613",2135,1821,667,100,51,151
"4614",1941,1707,1546,34,37,71
"4615",1914,1809,33,151,154,305
"4616",1439,952,232,40,32,72
"4617",1924,1651,370,170,146,316
"4618",153,2156,410,33,61,94
"4619",13,2138,467,36,33,69
"4620",1905,1414,482,70,69,139
"4621",1853,1400,532,68,50,118
"4622",2225,1750,632,110,115,225
"4623",2216,1742,682,101,117,218
"4624",1227,758,776,42,33,75
"4625",2339,1854,1632,91,84,175
"4626",2353,1947,1676,201,227,428
"4627",9,2006,1776,39,56,95
"4628",1716,1541,1821,52,51,103
"4629",6,2101,1830,63,86,149
"4630",1711,1213,1832,59,38,97
"4631",1801,1347,1836,66,77,143
"4632",1733,1322,326,38,32,70
"4633",1737,1345,458,42,50,92
"4634",2012,1833,1511,43,38,81
"4635",7,2206,1644,52,51,103
"4636",2002,1827,1795,33,37,70
"4637",1258,1018,309,108,88,196
"4638",19,2014,310,40,74,114
"4639",1300,833,332,35,43,78
"4640",1722,1504,370,48,39,87
"4641",1715,1234,432,109,109,218
"4642",1844,1358,532,59,48,107
"4643",2015,1719,606,91,99,190
"4644",1610,1508,623,41,46,87
"4645",2241,1755,632,126,120,246
"4646",2052,1812,667,57,42,99
"4647",1842,1551,767,93,71,164
"4648",2124,2038,1441,67,73,140
"4649",2347,2015,1488,33,50,83
"4650",1724,1541,1589,64,41,105
"4651",2309,1826,1632,61,56,117
"4652",1440,1220,1646,107,120,227
"4653",1955,1634,1648,43,49,92
"4654",1518,1216,1656,61,71,132
"4655",7,2010,1776,37,60,97
"4656",2115,1934,1826,50,34,84
"4657",1747,1315,1832,95,100,195
"4658",1338,1017,1,43,42,85
"4659",1944,1841,5,57,61,118
"4660",2142,2048,479,31,33,64
"4661",1617,1516,623,48,54,102
"4662",104,2119,658,128,139,267
"4663",2121,2031,1441,64,66,130
"4664",1429,1120,1448,38,55,93
"4665",1955,1650,1536,40,55,95
"4666",1810,1646,1589,119,121,240
"4667",1458,1137,1690,41,52,93
"4668",1657,1442,146,72,87,159
"4669",2342,2149,489,38,49,87
"4670",28,2219,752,55,59,114
"4671",2104,2012,1603,122,117,239
"4672",1353,1059,1646,63,39,102
"4673",1636,1500,137,41,40,81
"4674",1907,1639,146,199,204,403
"4675",2318,2014,190,41,64,105
"4676",1822,1706,275,62,76,138
"4677",2350,2136,344,42,66,108
"4678",1227,1002,346,64,77,141
"4679",2232,1956,444,39,41,80
"4680",2213,2114,479,62,59,121
"4681",1348,1237,499,40,52,92
"4682",1654,1422,546,156,157,313
"4683",2143,1916,746,278,286,564
"4684",1756,1451,786,73,86,159
"4685",2212,1955,1546,185,205,390
"4686",1433,1300,1605,71,70,141
"4687",1522,1238,1646,149,138,287
"4688",2002,1648,1648,50,63,113
"4689",1115,839,1746,72,74,146
"4690",2038,1949,1779,86,94,180
"4691",1435,1055,1,100,80,180
"4692",1918,1813,5,31,33,64
"4693",2133,1950,47,48,40,88
"4694",1621,1352,146,33,37,70
"4695",1442,1341,379,38,31,69
"4696",2138,1743,412,44,39,83
"4697",2215,2054,417,70,74,144
"4698",8,2204,489,61,64,125
"4699",1527,1243,546,69,58,127
"4700",1750,1602,795,37,32,69
"4701",2259,1822,1632,51,52,103
"4702",51,2258,1644,96,103,199
"4703",1415,1138,1646,82,78,160
"4704",1957,1853,5,70,73,143
"4705",2003,1837,1511,32,40,72
"4706",1546,1459,1541,35,39,74
"4707",1546,1108,232,107,108,215
"4708",1640,1554,320,87,89,176
"4709",1329,848,332,64,58,122
"4710",1651,1217,432,85,92,177
"4711",2035,1622,532,170,192,362
"4712",2248,2019,616,49,69,118
"4713",2111,1700,632,36,65,101
"4714",2153,1720,682,78,95,173
"4715",52,2027,732,82,92,174
"4716",2351,2049,755,41,49,90
"4717",2352,1916,1632,104,106,210
"4718",1943,1847,1779,31,32,63
"4719",1802,1311,1832,110,96,206
"4720",2052,1834,5,125,54,179
"4721",2318,2000,190,41,50,91
"4722",1832,1443,214,135,88,223
"4723",1858,1610,246,48,40,88
"4724",19,2039,250,91,94,185
"4725",2,2238,299,102,103,205
"4726",1308,1008,346,105,83,188
"4727",1146,802,544,64,67,131
"4728",2128,1917,570,79,82,161
"4729",2343,2233,597,72,83,155
"4730",1510,1335,738,68,50,118
"4731",104,2058,755,114,58,172
"4732",33,2233,770,83,93,176
"4733",2242,2202,820,63,67,130
"4734",1745,1618,1497,40,33,73
"4735",2237,1935,1506,39,45,84
"4736",2334,1939,1558,93,99,192
"4737",1818,1424,1562,126,79,205
"4738",8,2205,1644,53,50,103
"4739",2321,2007,1662,52,52,104
"4740",121,2206,1748,163,176,339
"4741",2353,2015,1794,95,85,180
"4742",2334,2014,1830,31,39,70
"4743",1908,1451,1850,148,116,264
"4744",1711,1440,146,83,85,168
"4745",1633,1328,214,41,38,79
"4746",2255,2141,299,35,46,81
"4747",153,2135,310,134,155,289
"4748",1443,1042,544,163,147,310
"4749",1638,1527,623,69,65,134
"4750",1100,931,799,32,32,64
"4751",2230,1924,1506,32,34,66
"4752",1353,1231,1605,34,41,75
"4753",1258,1223,1620,32,43,75
"4754",1917,1749,1787,130,114,244
"4755",50,2116,1794,57,51,108
"4756",2302,1950,190,37,40,77
"4757",1532,1144,358,33,35,68
"4758",2344,2044,1506,110,110,220
"4759",1617,1327,1751,94,108,202
"4760",11,2005,1776,42,45,87
"4761",2206,1909,1889,110,64,174
"4762",1950,1526,62,52,61,113
"4763",1448,959,232,49,40,89
"4764",2013,1635,244,40,50,90
"4765",1911,1621,246,53,41,94
"4766",34,2048,426,68,93,161
"4767",1622,1135,432,61,55,116
"4768",1929,1426,532,94,61,155
"4769",2231,1748,632,123,110,233
"4770",19,1944,732,58,39,97
"4771",1210,806,776,32,43,75
"4772",1526,1127,1476,46,62,108
"4773",52,2115,1488,103,115,218
"4774",1824,1512,1562,49,47,96
"4775",1129,803,1590,37,38,75
"4776",13,1951,1632,120,126,246
"4777",8,2207,1644,61,67,128
"4778",1737,1257,1832,77,67,144
"4779",1803,1333,1836,78,63,141
"4780",1709,1415,2242,33,42,75
"4781",1059,759,1235,49,59,108
"4782",2313,1936,1417,111,79,190
"4783",2345,1945,2095,160,105,265
"4784",1831,1517,1235,501,497,998
"4785",1359,1100,375,101,105,206
"4786",2137,1739,8,164,109,273
"4787",1310,952,375,52,37,89
"4788",2301,1957,2095,116,117,233
"4789",1731,1426,2242,55,53,108
"4790",1558,1457,876,48,62,110
"4791",2248,2159,1565,48,44,92
"4792",1054,1014,2025,69,74,143
"4793",2019,1838,39,59,63,122
"4794",2243,1901,1919,53,71,124
"4795",1727,1413,1164,187,193,380
"4796",1943,1831,1095,208,186,394
"4797",2246,2157,1377,61,62,123
"4798",1658,1600,28,178,180,358
"4799",1911,1818,46,41,48,89
"4800",2143,2052,48,163,172,335
"4801",2001,1907,50,31,37,68
"4802",2300,2209,52,180,189,369
"4803",2215,2124,58,50,54,104
"4804",1850,1732,3675,80,92,172
"4805",2001,1908,906,41,48,89
"4806",1425,1337,1147,40,52,92
"4807",2222,2126,854,32,36,68
"4808",2335,2230,1401,135,140,275
"4809",2203,1911,43,33,41,74
"4810",1755,1641,1072,145,156,301
"4811",1434,1258,122,79,93,172
"4812",2041,1904,1752,206,219,425
"4813",2104,1958,1861,49,58,107
"4814",2232,2110,1655,172,175,347
"4815",1934,1727,33,64,82,146
"4816",109,2301,806,119,131,250
"4817",1424,1311,11,139,126,265
"4818",1900,1751,35,85,76,161
"4819",1238,1140,731,108,110,218
"4820",939,844,1094,79,84,163
"4821",1657,1600,1639,217,220,437
"4822",1956,1849,1214,76,89,165
"4823",2101,2024,1040,56,79,135
"4824",2224,2132,2539,34,42,76
"4825",1328,1158,708,93,93,186
"4826",2004,1919,602,64,74,138
"4827",1729,1637,915,79,82,161
"4828",2231,2041,215,46,51,97
"4829",2004,1713,31,89,98,187
"4830",2044,1923,1580,139,143,282
"4831",2026,1849,39,66,74,140
"4832",2359,2008,47,34,43,77
"4833",3,2014,1919,133,144,277
"4834",1542,1202,1164,82,62,144
"4835",2319,2233,1377,94,98,192
"4836",1432,1337,28,32,37,69
"4837",1812,1719,42,37,49,86
"4838",1912,1819,46,42,49,91
"4839",1931,1842,48,31,42,73
"4840",2013,1919,50,43,49,92
"4841",2321,2205,1332,46,65,111
"4842",1856,1803,27,211,218,429
"4843",2257,2200,55,37,40,77
"4844",2255,2201,854,65,71,136
"4845",2203,1915,43,33,45,78
"4846",1754,1613,1752,39,48,87
"4847",2048,1937,1861,33,37,70
"4848",2102,1942,1655,82,87,169
"4849",2353,2053,49,33,43,76
"4850",2241,2027,1003,41,52,93
"4851",1124,1028,731,34,38,72
"4852",2248,2153,1179,98,103,201
"4853",2034,1916,1214,114,116,230
"4854",2346,2059,1212,36,49,85
"4855",2224,1843,3188,34,48,82
"4856",2049,1922,2690,69,42,111
"4857",2225,2107,5008,75,92,167
"4858",2308,2206,1565,68,51,119
"4859",1315,1227,15,45,47,92
"4860",2332,2241,1377,107,106,213
"4861",2321,2232,60,86,92,178
"4862",5,2209,1332,90,69,159
"4863",1443,1347,1147,58,62,120
"4864",2305,2206,55,45,46,91
"4865",2204,1904,43,34,34,68
"4866",2328,2209,776,38,44,82
"4867",1932,1819,1214,52,59,111
"4868",2305,2207,757,45,42,87
"4869",1440,1356,1442,40,41,81
"4870",1424,1246,963,39,51,90
"4871",2245,2153,60,50,53,103
"4872",1813,1653,1899,83,73,156
"4873",2324,2036,43,114,126,240
"4874",1747,1603,1752,32,38,70
"4875",2356,1949,37,156,164,320
"4876",9,2017,47,44,52,96
"4877",2224,2131,1179,74,81,155
"4878",2303,1852,37,103,107,210
"4879",1243,1207,2025,178,187,365
"4880",1422,1242,963,37,47,84
"4881",1502,1156,1164,42,56,98
"4882",2315,2233,1377,90,98,188
"4883",1237,1107,778,47,47,94
"4884",3,2243,51,123,138,261
"4885",2247,2033,1003,47,58,105
"4886",1911,1700,1352,231,245,476
"4887",1816,1718,35,41,43,84
"4888",2008,1912,1286,48,52,100
"4889",11,1953,37,171,168,339
"4890",1256,1125,708,61,60,121
"4891",2232,1840,1919,42,50,92
"4892",2245,2200,1377,60,65,125
"4893",1440,1346,28,40,46,86
"4894",1503,1410,30,38,40,78
"4895",2119,2023,50,109,113,222
"4896",1802,1636,3675,32,36,68
"4897",7,2246,51,127,141,268
"4898",1528,1224,9,98,109,207
"4899",1841,1746,1389,91,96,187
"4900",26,2138,43,176,188,364
"4901",2029,1902,676,34,37,71
"4902",1551,1407,122,156,162,318
"4903",131,2327,806,141,157,298
"4904",1546,1451,11,221,226,447
"4905",1807,1716,35,32,41,73
"4906",2054,2002,1286,94,102,196
"4907",2238,2016,1727,38,36,74
"4908",1953,1839,1214,73,79,152
"4909",1344,1232,1223,119,127,246
"4910",1554,1505,862,64,70,134
"4911",1616,1450,708,261,265,526
"4912",2003,1914,602,63,69,132
"4913",2352,2304,757,92,99,191
"4914",1311,1128,7,81,93,174
"4915",2301,2114,215,76,84,160
"4916",2010,1823,1296,150,158,308
"4917",1715,1600,3654,70,80,150
"4918",2305,2139,1930,80,89,169
"4919",1337,1212,3056,62,72,134
"4920",2151,2010,39,151,155,306
"4921",1518,1340,963,93,105,198
"4922",1600,1201,1106,35,31,66
"4923",1816,1722,38,106,112,218
"4924",1859,1801,42,84,91,175
"4925",1312,1132,778,82,72,154
"4926",1956,1820,3675,146,140,286
"4927",2258,2211,55,38,51,89
"4928",2244,2154,854,54,64,118
"4929",1812,1709,1389,62,59,121
"4930",1459,1326,122,104,121,225
"4931",27,2128,49,67,78,145
"4932",1232,1108,708,37,43,80
"4933",2300,2202,757,40,37,77
"4934",1211,1110,2798,136,130,266
"4935",2238,1838,3188,48,43,91
"4936",1853,1807,168,33,37,70
"4937",1557,1423,765,37,33,70
"4938",2157,2106,3874,82,91,173
"4939",2110,2008,1221,45,68,113
"4940",1939,1627,1990,89,92,181
"4941",2208,2115,2564,98,105,203
"4942",2123,2046,893,48,71,119
"4943",2237,2124,5008,87,109,196
"4944",2319,2231,1745,89,96,185
"4945",1420,1237,963,35,42,77
"4946",2004,1910,50,34,40,74
"4947",2306,2145,1332,31,45,76
"4948",1046,926,1695,56,66,122
"4949",1800,1706,1389,50,56,106
"4950",1721,1617,1899,31,37,68
"4951",1629,1326,502,94,106,200
"4952",2203,2108,1179,53,58,111
"4953",2037,2002,1040,32,57,89
"4954",2245,2055,215,60,65,125
"4955",1404,1236,3056,89,96,185
"4956",1754,1702,1095,99,97,196
"4957",1443,1352,28,43,52,95
"4958",1744,1651,40,44,51,95
"4959",1917,1819,46,47,49,96
"4960",1441,1310,19,41,45,86
"4961",2255,2159,55,35,39,74
"4962",1756,1700,1389,46,50,96
"4963",1809,1655,1899,79,75,154
"4964",2201,1903,43,31,33,64
"4965",1543,1401,122,148,156,304
"4966",1142,1048,731,52,58,110
"4967",950,856,1094,90,96,186
"4968",1229,1118,708,34,53,87
"4969",2218,2027,215,33,37,70
"4970",121,2231,1212,131,141,272
"4971",1422,1240,963,37,45,82
"4972",234,2247,47,189,202,391
"4973",1556,1202,1106,31,32,63
"4974",1453,1137,1164,33,37,70
"4975",2342,2250,1377,117,115,232
"4976",2136,1959,44,216,179,395
"4977",2139,1959,46,189,149,338
"4978",2128,1954,48,148,114,262
"4979",2032,1937,50,62,67,129
"4980",2120,1955,52,80,55,135
"4981",2227,2124,58,62,54,116
"4982",2230,2135,60,35,35,70
"4983",102,2332,51,182,187,369
"4984",5,2315,55,105,115,220
"4985",2116,1948,1861,61,48,109
"4986",41,2140,49,81,90,171
"4987",208,2345,806,178,175,353
"4988",2149,2055,1179,39,45,84
"4989",2354,2143,1727,114,123,237
"4990",2047,1923,1214,127,123,250
"4991",2221,2141,2539,31,51,82
"4992",1655,1530,3654,50,50,100
"4993",2028,1828,39,68,53,121
"4994",1712,1626,1095,57,61,118
"4995",1458,1409,28,58,69,127
"4996",1641,1552,36,46,52,98
"4997",1944,1856,48,44,56,100
"4998",2354,2058,43,144,148,292
"4999",2355,2052,49,35,42,77
"5000",2321,1901,37,121,116,237
"5001",1546,1506,862,56,71,127
"5002",1916,1815,1425,36,50,86
"5003",1918,1833,511,98,98,196
"5004",1432,1352,1442,32,37,69
"5005",1349,1216,3056,74,76,150
"5006",1954,1815,39,34,40,74
"5007",13,2031,47,48,66,114
"5008",140,2157,1919,230,247,477
"5009",1934,1846,41,49,51,100
"5010",2232,2142,1377,47,47,94
"5011",910,817,6,40,47,87
"5012",1348,1255,24,53,55,108
"5013",1514,1411,30,49,41,90
"5014",1905,1811,42,90,101,191
"5015",1911,1817,46,41,47,88
"5016",2009,1917,50,39,47,86
"5017",2227,2135,58,62,65,127
"5018",2235,2140,60,40,40,80
"5019",1442,1313,19,42,48,90
"5020",2239,2111,51,39,46,85
"5021",1641,1551,1147,176,186,362
"5022",1431,1112,9,41,37,78
"5023",8,2055,1778,38,40,78
"5024",1709,1402,23,34,37,71
"5025",2235,2139,854,45,49,94
"5026",2205,1911,43,35,41,76
"5027",2053,1937,676,58,72,130
"5028",1955,1840,1072,265,275,540
"5029",1406,1237,122,51,72,123
"5030",1818,1635,1752,63,70,133
"5031",2010,1644,401,55,39,94
"5032",2002,1748,33,92,103,195
"5033",17,2216,806,67,86,153
"5034",2308,2057,1003,68,82,150
"5035",1818,1717,35,43,42,85
"5036",1356,1259,1639,36,39,75
"5037",1913,1754,1214,33,34,67
"5038",2250,2059,215,65,69,134
"5039",1937,1633,31,62,58,120
"5040",1743,1446,23,68,81,149
"5041",1919,1825,1389,129,135,264
"5042",1615,1509,1072,45,64,109
"5043",2023,1906,1655,43,51,94
"5044",2000,1656,401,45,51,96
"5045",1951,1858,1286,31,38,69
"5046",2234,2028,1727,34,48,82
"5047",2120,2015,3973,40,50,90
"5048",1623,1154,2484,78,64,142
"5049",1036,945,574,86,95,181
"5050",2229,2105,1930,44,55,99
"5051",2234,2147,1377,49,52,101
"5052",1636,1548,34,66,78,144
"5053",2330,2242,58,125,132,257
"5054",2333,2244,60,98,104,202
"5055",32,2306,51,152,161,313
"5056",109,12,55,169,172,341
"5057",1756,1704,1389,46,54,100
"5058",1724,1618,1899,34,38,72
"5059",2030,1904,676,35,39,74
"5060",7,2234,2725,62,79,141
"5061",1952,1639,401,37,34,71
"5062",1133,1043,731,43,53,96
"5063",1958,1904,1286,38,44,82
"5064",227,2214,37,307,309,616
"5065",1959,1908,511,139,133,272
"5066",2251,2206,1565,51,51,102
"5067",12,2247,1930,147,157,304
"5068",2244,2059,39,204,204,408
"5069",1617,1225,1106,52,55,107
"5070",2302,1906,1919,72,76,148
"5071",2254,2209,1377,69,74,143
"5072",1413,1253,24,78,53,131
"5073",1850,1713,28,290,253,543
"5074",1927,1714,30,302,224,526
"5075",1832,1704,32,212,184,396
"5076",1900,1712,34,210,162,372
"5077",1918,1724,36,203,144,347
"5078",1931,1735,38,181,125,306
"5079",2005,1748,40,185,108,293
"5080",2009,1819,44,129,79,208
"5081",2059,1837,46,149,67,216
"5082",2051,1838,48,111,38,149
"5083",2054,1902,50,84,32,116
"5084",2310,2145,1332,35,45,80
"5085",1444,1304,19,44,39,83
"5086",2321,2154,51,81,89,170
"5087",1508,1155,9,78,80,158
"5088",2330,2239,55,70,79,149
"5089",31,2133,43,181,183,364
"5090",2126,1905,676,91,40,131
"5091",1850,1625,1752,95,60,155
"5092",2349,2158,2725,44,43,87
"5093",2325,2207,1861,190,187,377
"5094",1319,1006,5,34,31,65
"5095",51,2147,49,91,97,188
"5096",1920,1701,33,50,56,106
"5097",1,2148,806,51,58,109
"5098",2052,1957,35,197,202,399
"5099",2144,2044,1179,34,34,68
"5100",1401,1259,1639,41,39,80
"5101",2258,2014,1727,58,34,92
"5102",1941,1803,1214,61,43,104
"5103",147,2145,37,267,280,547
"5104",2227,2129,1040,142,144,286
"5105",119,37,2539,209,227,436
"5106",2057,1838,681,87,38,125
"5107",1316,1129,7,86,94,180
"5108",2011,1703,31,96,88,184
"5109",1751,1522,3654,106,42,148
"5110",1228,1106,9,53,41,94
"5111",2147,2059,819,92,89,181
"5112",1123,1036,2025,98,96,194
"5113",1534,1445,2708,59,55,114
"5114",2000,1815,39,40,45,85
"5115",39,2058,45,94,118,212
"5116",1208,821,349,43,56,99
"5117",1549,1501,27,34,36,70
"5118",2042,1955,41,107,110,217
"5119",2208,2120,325,43,45,88
"5120",1920,1753,44,85,53,138
"5121",2121,2007,50,111,97,208
"5122",2228,2114,58,63,44,107
"5123",2303,2203,60,68,63,131
"5124",1937,1800,35,92,95,187
"5125",2319,2136,453,124,121,245
"5126",2336,2216,49,131,141,272
"5127",1848,1748,429,53,48,101
"5128",51,2147,47,126,142,268
"5129",11,2317,55,111,112,223
"5130",23,2327,313,213,212,425
"5131",2302,2153,234,62,63,125
"5132",145,2256,51,115,136,251
"5133",2311,2008,362,41,48,89
"5134",1939,1606,565,174,106,280
"5135",2211,2113,476,31,33,64
"5136",1900,1805,621,65,70,135
"5137",2110,2014,678,75,79,154
"5138",1414,1137,301,79,57,136
"5139",2232,2103,117,67,58,125
"5140",2320,1908,37,115,123,238
"5141",1700,1602,31,45,32,77
"5142",2125,2013,720,90,63,153
"5143",1157,1020,795,52,40,92
"5144",2328,2240,410,113,115,228
"5145",2136,1920,395,131,105,236
"5146",2113,2030,819,58,60,118
"5147",2246,2122,773,31,42,73
"5148",1810,1416,756,95,106,201
"5149",2322,1933,934,92,108,200
"5150",1553,1508,27,38,43,81
"5151",1541,1446,32,46,46,92
"5152",1732,1636,38,62,66,128
"5153",1750,1654,40,50,54,104
"5154",1933,1840,48,33,40,73
"5155",2235,2138,60,40,38,78
"5156",2159,2030,453,44,55,99
"5157",1526,1429,300,46,44,90
"5158",1847,1752,429,52,52,104
"5159",2314,2208,234,74,78,152
"5160",1543,1433,1154,53,53,106
"5161",2105,1842,659,35,37,72
"5162",2230,2005,1055,45,45,90
"5163",1841,1744,621,46,49,95
"5164",2202,2037,117,37,32,69
"5165",2159,1747,37,34,42,76
"5166",2046,1956,720,51,46,97
"5167",2248,2159,410,73,74,147
"5168",219,2333,1271,159,173,332
"5169",1326,1206,679,51,51,102
"5170",2106,1955,2299,101,100,201
"5171",2134,2054,104,229,234,463
"5172",2132,2053,819,77,83,160
"5173",2316,2154,773,61,74,135
"5174",2103,1920,39,103,110,213
"5175",1656,1609,27,101,104,205
"5176",1936,1853,41,41,48,89
"5177",2200,2112,325,35,37,72
"5178",1511,1412,30,41,42,83
"5179",1710,1601,32,135,121,256
"5180",1710,1610,38,40,40,80
"5181",1735,1636,40,35,36,71
"5182",1847,1748,44,52,48,100
"5183",2005,1907,50,35,37,72
"5184",2140,2047,56,45,47,92
"5185",2253,2153,58,88,83,171
"5186",1559,1505,300,79,80,159
"5187",103,2201,47,138,156,294
"5188",1519,1414,939,69,59,128
"5189",1607,1508,2725,42,43,85
"5190",2246,2142,234,46,52,98
"5191",1611,1508,1154,81,88,169
"5192",1640,1509,1420,40,49,89
"5193",1904,1748,630,44,48,92
"5194",29,2120,51,39,40,79
"5195",1709,1354,237,39,39,78
"5196",3,2057,3938,93,97,190
"5197",2353,2134,1767,63,64,127
"5198",2233,2140,476,53,60,113
"5199",1838,1744,621,43,49,92
"5200",950,821,171,50,36,86
"5201",1838,1723,1056,93,98,191
"5202",150,2210,37,265,305,570
"5203",2044,2000,720,49,50,99
"5204",1502,1409,2170,57,49,106
"5205",2208,2117,410,33,32,65
"5206",1839,1751,2218,44,51,95
"5207",2205,2005,395,160,150,310
"5208",1949,1654,33,54,59,113
"5209",1715,1413,451,135,138,273
"5210",2221,2058,374,76,73,149
"5211",1318,1155,679,43,40,83
"5212",1212,1108,662,37,43,80
"5213",1602,1520,2708,87,90,177
"5214",2005,1819,39,45,49,94
"5215",1842,1452,756,127,142,269
"5216",1502,1406,30,32,36,68
"5217",1755,1645,34,150,135,285
"5218",2140,2046,52,100,106,206
"5219",1250,1130,131,35,40,75
"5220",2213,2056,453,58,81,139
"5221",1857,1804,1919,62,64,126
"5222",1400,1243,1104,50,48,98
"5223",1900,1716,1420,180,176,356
"5224",2323,2110,1767,33,40,73
"5225",2211,2116,476,31,36,67
"5226",2255,2046,2994,65,71,136
"5227",2400,1956,37,155,171,326
"5228",1711,1627,31,56,57,113
"5229",2212,2125,410,37,40,77
"5230",1459,1307,372,34,37,71
"5231",2118,1826,33,143,151,294
"5232",2039,1934,1793,34,39,73
"5233",1936,1848,3175,51,48,99
"5234",1336,948,3142,56,68,124
"5235",1935,1841,329,35,41,76
"5236",1921,1807,1889,51,37,88
"5237",2035,1942,3452,100,102,202
"5238",1811,1718,479,36,38,74
"5239",2106,1926,1924,46,41,87
"5240",2351,2045,18,61,65,126
"5241",1909,1816,61,39,46,85
"5242",1606,1520,2074,31,40,71
"5243",2306,2207,2009,39,52,91
"5244",1726,1414,2010,38,34,72
"5245",1811,1512,2010,83,92,175
"5246",1841,1540,2010,113,120,233
"5247",1804,1456,2010,76,76,152
"5248",2324,2010,2024,67,70,137
"5249",1641,1523,2025,48,34,82
"5250",2048,1908,2025,289,253,542
"5251",2358,2034,2027,66,74,140
"5252",2339,2025,2027,47,65,112
"5253",2337,2004,2027,45,44,89
"5254",2341,2017,2027,54,57,111
"5255",2335,2013,2027,43,53,96
"5256",1621,1515,2033,59,50,109
"5257",1151,804,2035,52,44,96
"5258",1351,1053,2036,41,43,84
"5259",2148,2023,2042,39,48,87
"5260",2250,2105,2042,96,90,186
"5261",2202,2033,2042,48,58,106
"5262",2220,2052,2042,66,77,143
"5263",2223,1859,2044,68,69,137
"5264",18,2031,2050,93,91,184
"5265",2343,2012,2050,58,72,130
"5266",2324,1947,2050,39,47,86
"5267",2054,1950,2062,82,85,167
"5268",2111,2005,2062,99,100,199
"5269",2054,1951,2062,82,86,168
"5270",2023,1919,2062,51,54,105
"5271",1511,1140,2064,111,90,201
"5272",1749,1614,2069,84,54,138
"5273",1127,1001,2079,71,62,133
"5274",1400,1248,2082,87,88,175
"5275",1515,1323,2082,162,113,275
"5276",1549,1435,2084,45,50,95
"5277",30,2105,2094,96,100,196
"5278",2332,2019,2094,38,54,92
"5279",23,2055,2094,89,90,179
"5280",2346,2007,2094,52,42,94
"5281",33,2109,2094,99,104,203
"5282",51,2131,2094,117,126,243
"5283",1757,1413,2105,94,78,172
"5284",1918,1651,2122,46,61,107
"5285",2102,1749,2122,150,119,269
"5286",2213,1856,2122,221,186,407
"5287",1923,1639,2122,51,49,100
"5288",2101,1828,2122,124,123,247
"5289",2007,1718,2122,95,88,183
"5290",1637,1539,2128,48,54,102
"5291",1653,1517,2128,64,32,96
"5292",2000,1820,2128,251,215,466
"5293",1745,1635,2128,116,110,226
"5294",1620,1516,2128,31,31,62
"5295",2354,2250,2131,92,85,177
"5296",2308,2213,2131,46,48,94
"5297",8,2215,2131,106,50,156
"5298",1133,1007,2132,160,152,312
"5299",1034,911,2132,106,96,202
"5300",2146,2001,2168,64,41,105
"5301",2351,2012,2171,54,67,121
"5302",2400,2017,2171,63,72,135
"5303",2351,2002,2171,54,57,111
"5304",1536,1413,2174,66,68,134
"5305",1543,1422,2174,73,77,150
"5306",1523,1405,2174,57,65,122
"5307",1844,1518,2198,70,63,133
"5308",1334,1218,2200,32,33,65
"5309",1342,1227,2200,40,42,82
"5310",2009,1908,2212,81,78,159
"5311",2058,2002,2212,130,132,262
"5312",2042,1929,2212,114,99,213
"5313",2032,1911,2212,104,81,185
"5314",1546,1420,2213,61,58,119
"5315",1536,1413,2213,84,83,167
"5316",1538,1411,2213,39,35,74
"5317",1948,1856,2214,34,31,65
"5318",1001,907,2216,56,55,111
"5319",1446,1330,2223,62,43,105
"5320",1218,838,2240,85,78,163
"5321",1152,820,2240,59,60,119
"5322",1247,951,2246,39,51,90
"5323",951,854,2254,39,39,78
"5324",1041,947,2254,89,92,181
"5325",1235,1126,2257,123,116,239
"5326",2322,2200,2261,67,35,102
"5327",2311,2225,2261,56,60,116
"5328",2335,2243,2261,80,78,158
"5329",2326,2236,2261,71,71,142
"5330",2321,2233,2261,66,68,134
"5331",1722,1516,2274,50,36,86
"5332",1814,1556,2274,102,76,178
"5333",2044,1732,2276,32,37,69
"5334",2204,1757,2276,112,62,174
"5335",2119,1813,2276,67,78,145
"5336",1311,1204,2277,44,39,83
"5337",1837,1615,2278,64,45,109
"5338",2222,2048,2280,44,38,82
"5339",2157,2038,2280,34,43,77
"5340",2232,2109,2280,69,74,143
"5341",2335,2215,2280,132,140,272
"5342",2154,2035,2280,31,40,71
"5343",2159,2040,2280,36,45,81
"5344",2202,2037,2280,39,42,81
"5345",2227,2102,2280,64,67,131
"5346",2227,2101,2280,64,66,130
"5347",1223,1121,2283,58,43,101
"5348",1306,1222,2283,106,112,218
"5349",2350,2039,2288,33,34,67
"5350",3,2048,2288,46,43,89
"5351",2357,2050,2288,45,45,90
"5352",56,2146,2288,99,101,200
"5353",1430,1100,2295,62,40,102
"5354",1433,1122,2295,70,62,132
"5355",2005,1707,2298,65,81,146
"5356",1936,1618,2298,47,38,85
"5357",1944,1630,2298,48,48,96
"5358",2029,1722,2298,89,96,185
"5359",2034,1734,2298,94,108,202
"5360",1945,1639,2298,45,53,98
"5361",2007,1705,2298,67,79,146
"5362",2040,1713,2298,100,87,187
"5363",2011,1705,2298,71,79,150
"5364",1954,1639,2298,69,68,137
"5365",2005,1700,2298,69,78,147
"5366",1937,1630,2298,43,50,93
"5367",2124,2028,2301,66,73,139
"5368",2105,2007,2301,47,52,99
"5369",2053,1955,2301,35,40,75
"5370",2127,2028,2301,69,73,142
"5371",2205,2108,2301,107,113,220
"5372",1239,1110,2301,31,40,71
"5373",1446,1333,2304,44,43,87
"5374",1715,1553,2308,60,43,103
"5375",1653,1542,2308,38,32,70
"5376",1736,1624,2308,81,74,155
"5377",1753,1651,2308,98,101,199
"5378",2118,1907,2314,40,37,77
"5379",2240,1953,2314,122,83,205
"5380",2136,1920,2314,58,50,108
"5381",2126,1924,2314,53,54,107
"5382",2123,1906,2314,45,36,81
"5383",1737,1409,2329,38,34,72
"5384",1747,1427,2329,53,52,105
"5385",1806,1509,2334,48,54,102
"5386",1852,1543,2334,107,98,205
"5387",1814,1513,2334,67,68,135
"5388",1740,1436,2334,35,31,66
"5389",1726,1544,2336,73,64,137
"5390",1828,1654,2346,41,49,90
"5391",1844,1645,2346,57,40,97
"5392",1907,1711,2346,80,66,146
"5393",2113,1958,2348,39,38,77
"5394",2131,2003,2348,57,43,100
"5395",46,2354,2349,149,149,298
"5396",50,2350,2349,153,145,298
"5397",2313,2209,2357,48,49,97
"5398",2332,2224,2357,72,64,136
"5399",2311,2201,2357,46,41,87
"5400",2328,2222,2357,63,62,125
"5401",2035,1841,2360,43,51,94
"5402",2027,1834,2360,35,44,79
"5403",1037,1005,2369,47,45,92
"5404",1042,1018,2369,52,58,110
"5405",932,852,2373,45,52,97
"5406",2046,1905,2376,58,55,113
"5407",2059,1920,2376,76,75,151
"5408",1740,1443,2380,32,39,71
"5409",1914,1555,2380,140,125,265
"5410",1729,1424,2380,39,34,73
"5411",1802,1451,2380,57,51,108
"5412",1903,1542,2380,129,112,241
"5413",1846,1509,2380,101,69,170
"5414",1452,1126,2386,40,41,81
"5415",1514,1139,2386,67,54,121
"5416",1825,1453,2389,81,58,139
"5417",1728,1419,2389,49,49,98
"5418",1902,1543,2389,143,133,276
"5419",1623,1429,2399,141,89,230
"5420",1440,1351,2399,48,61,109
"5421",1313,954,2400,75,64,139
"5422",1251,929,2400,53,39,92
"5423",1323,948,2400,85,58,143
"5424",1744,1442,2405,31,32,63
"5425",1813,1445,2405,60,35,95
"5426",1842,1539,2405,89,89,178
"5427",1938,1612,2405,145,122,267
"5428",1821,1447,2405,68,37,105
"5429",1316,1226,2407,49,51,100
"5430",1309,1226,2407,42,51,93
"5431",2220,2128,2418,75,73,148
"5432",2108,2029,2418,46,57,103
"5433",2231,2147,2418,101,107,208
"5434",2130,2047,2418,40,47,87
"5435",2105,2012,2418,43,40,83
"5436",2113,2035,2418,51,63,114
"5437",2011,1904,2425,44,44,88
"5438",2105,2001,2425,98,101,199
"5439",2135,2030,2425,128,130,258
"5440",2054,1928,2425,87,68,155
"5441",2136,2029,2425,129,129,258
"5442",1649,1452,2427,62,32,94
"5443",1807,1639,2427,140,139,279
"5444",1637,1455,2427,50,35,85
"5445",1730,1504,2427,103,44,147
"5446",1156,841,2432,36,41,77
"5447",1259,940,2432,94,100,194
"5448",1331,955,2432,126,115,241
"5449",1404,1227,2433,76,62,138
"5450",1748,1657,2442,53,57,110
"5451",1810,1617,2442,105,47,152
"5452",127,33,2450,93,88,181
"5453",1058,1006,2451,33,36,69
"5454",1825,1713,2465,33,43,76
"5455",1913,1749,2465,80,78,158
"5456",1826,1702,2465,34,32,66
"5457",1107,843,2470,32,51,83
"5458",1836,1511,2472,69,46,115
"5459",1806,1457,2472,39,32,71
"5460",1704,1407,2472,43,47,90
"5461",1931,1637,2472,109,117,226
"5462",1804,1614,2474,47,44,91
"5463",1826,1613,2474,64,43,107
"5464",1820,1617,2474,58,47,105
"5465",1722,1459,2479,56,44,100
"5466",1820,1608,2479,51,33,84
"5467",1818,1621,2479,49,46,95
"5468",2135,1824,2479,246,169,415
"5469",1824,1636,2479,55,61,116
"5470",2046,1955,2481,37,40,77
"5471",2046,1952,2481,37,37,74
"5472",2140,2037,2481,91,82,173
"5473",1235,1110,2482,48,40,88
"5474",2045,1706,2488,52,31,83
"5475",2038,1713,2488,45,38,83
"5476",2122,1803,2488,94,88,182
"5477",2355,2027,2488,247,232,479
"5478",2031,1715,2488,38,40,78
"5479",2052,1722,2488,59,47,106
"5480",2053,1741,2488,60,66,126
"5481",2050,1724,2492,96,104,200
"5482",2105,1651,2492,103,66,169
"5483",2144,1808,2492,147,143,290
"5484",5,2228,2493,68,68,136
"5485",2348,2220,2493,51,60,111
"5486",2011,1828,2497,100,95,195
"5487",1915,1736,2497,62,61,123
"5488",2132,1910,2497,199,155,354
"5489",1923,1735,2497,70,60,130
"5490",1945,1805,2497,74,72,146
"5491",1600,1427,2499,95,62,157
"5492",1525,1407,2499,60,42,102
"5493",1643,1253,2520,150,114,264
"5494",1528,1224,2520,75,85,160
"5495",1945,1836,2562,78,66,144
"5496",1902,1811,2562,35,41,76
"5497",2102,1941,2562,155,131,286
"5498",1936,1835,2562,69,65,134
"5499",1710,1323,2568,162,163,325
"5500",1810,1450,2572,68,65,133
"5501",1809,1454,2572,67,69,136
"5502",1030,836,2573,83,76,159
"5503",1010,811,2573,58,51,109
"5504",1714,1602,2581,100,82,182
"5505",1608,1515,2581,34,35,69
"5506",1639,1514,2581,65,34,99
"5507",1614,1519,2581,40,39,79
"5508",1159,845,2586,65,65,130
"5509",1554,1451,2591,43,41,84
"5510",1556,1504,2591,33,34,67
"5511",1643,1337,2593,100,37,137
"5512",1551,1356,2593,48,56,104
"5513",1628,1350,2593,85,50,135
"5514",2352,2051,2597,67,76,143
"5515",2357,2017,2597,72,42,114
"5516",2322,2023,2597,37,48,85
"5517",157,2301,2597,192,206,398
"5518",132,2226,2597,167,171,338
"5519",46,2143,2597,121,128,249
"5520",111,2206,2597,151,151,302
"5521",2344,2038,2597,59,63,122
"5522",2145,1934,2598,137,119,256
"5523",2028,1839,2598,60,64,124
"5524",2043,1850,2598,75,75,150
"5525",2034,1841,2598,66,66,132
"5526",2022,1814,2598,54,39,93
"5527",2132,1931,2598,124,116,240
"5528",2012,1819,2598,44,44,88
"5529",1535,1352,2600,83,62,145
"5530",1538,1405,2600,86,75,161
"5531",1617,1451,2600,73,72,145
"5532",1547,1512,2601,43,37,80
"5533",1618,1542,2601,44,37,81
"5534",1104,1005,2605,34,35,69
"5535",1126,819,2612,33,44,77
"5536",1411,1057,2617,53,42,95
"5537",1435,1100,2617,72,45,117
"5538",1501,1142,2617,98,87,185
"5539",1710,1556,2625,47,33,80
"5540",1728,1603,2625,65,40,105
"5541",1727,1602,2625,64,39,103
"5542",2030,1710,2629,248,235,483
"5543",1656,1348,2629,34,33,67
"5544",1840,1538,2629,138,143,281
"5545",1645,1528,2631,78,53,131
"5546",1624,1526,2631,57,51,108
"5547",1153,944,2632,38,34,72
"5548",1244,1030,2632,94,80,174
"5549",1019,821,2641,32,31,63
"5550",1110,1005,2649,31,38,69
"5551",1153,1030,2649,74,63,137
"5552",1142,1028,2649,63,61,124
"5553",2147,1948,2651,50,43,93
"5554",2212,2021,2651,75,76,151
"5555",2210,2033,2651,73,88,161
"5556",1438,1120,2652,39,40,79
"5557",2333,2214,2654,61,49,110
"5558",2350,2242,2654,78,77,155
"5559",2310,2205,2654,38,40,78
"5560",1914,1813,2658,40,43,83
"5561",2051,1852,2658,137,82,219
"5562",2043,1923,2658,129,113,242
"5563",2357,2251,2669,99,91,190
"5564",2321,2215,2669,63,55,118
"5565",2348,2237,2669,90,77,167
"5566",124,2355,2669,186,155,341
"5567",2330,2233,2692,83,78,161
"5568",2312,2222,2692,65,67,132
"5569",2318,2224,2692,71,69,140
"5570",2229,1939,2700,114,124,238
"5571",2111,1807,2700,36,32,68
"5572",2331,2012,2700,176,157,333
"5573",2153,1900,2700,78,85,163
"5574",1916,1808,2705,94,98,192
"5575",1921,1809,2705,84,84,168
"5576",1820,1712,2705,38,42,80
"5577",1914,1756,2705,92,86,178
"5578",1818,1712,2705,36,42,78
"5579",1915,1754,2705,93,84,177
"5580",2203,1931,2712,63,36,99
"5581",1836,1439,2715,109,64,173
"5582",1818,1516,2715,76,86,162
"5583",1752,1444,2715,65,69,134
"5584",1622,1500,2719,37,35,72
"5585",1700,1532,2719,75,67,142
"5586",2338,2034,2728,249,242,491
"5587",2027,1731,2728,58,59,117
"5588",2203,1852,2728,154,140,294
"5589",2021,1727,2728,52,55,107
"5590",1249,1102,2729,31,32,63
"5591",1320,1109,2729,62,39,101
"5592",1235,1035,2730,82,70,152
"5593",1240,1042,2730,87,77,164
"5594",2034,1937,2731,39,37,76
"5595",2119,2031,2731,82,86,168
"5596",2146,2054,2731,109,109,218
"5597",2221,2129,2731,122,122,244
"5598",2102,2019,2731,65,74,139
"5599",2152,2058,2731,115,113,228
"5600",2113,2025,2731,76,80,156
"5601",2144,2034,2731,85,67,152
"5602",1352,1035,2734,55,50,105
"5603",1715,1420,2736,245,250,495
"5604",1905,1757,2748,42,52,94
"5605",2123,2007,2748,180,182,362
"5606",1849,1736,2748,31,31,62
"5607",2011,1856,2748,108,111,219
"5608",2012,1901,2748,109,116,225
"5609",1944,1824,2748,86,79,165
"5610",1259,1121,2750,62,66,128
"5611",1708,1612,2755,53,52,105
"5612",1858,1801,2755,163,161,324
"5613",2103,1912,2759,66,52,118
"5614",2323,2150,2759,206,210,416
"5615",2014,1840,2759,32,35,67
"5616",2014,1849,2759,32,44,76
"5617",2137,1913,2759,115,68,183
"5618",2232,2055,2759,160,160,320
"5619",1511,1225,2763,48,40,88
"5620",1528,1444,2769,46,49,95
"5621",1535,1438,2769,53,43,96
"5622",1719,1532,2769,157,97,254
"5623",1557,1448,2769,75,53,128
"5624",1618,1512,2773,70,72,142
"5625",2227,1848,2781,130,138,268
"5626",2323,2023,2782,33,33,66
"5627",2330,2035,2782,40,45,85
"5628",2358,2106,2782,68,76,144
"5629",2353,2052,2782,63,62,125
"5630",2400,2058,2782,70,68,138
"5631",20,2129,2782,90,99,189
"5632",2322,2022,2782,32,32,64
"5633",1930,1753,2784,96,73,169
"5634",1833,1725,2784,39,45,84
"5635",1906,1744,2784,72,64,136
"5636",1933,1821,2784,99,101,200
"5637",1845,1736,2784,38,43,81
"5638",1912,1806,2784,78,86,164
"5639",1900,1541,2791,131,136,267
"5640",1849,1514,2791,120,109,229
"5641",1757,1411,2791,68,46,114
"5642",1603,1405,2793,40,35,75
"5643",1316,1010,2799,149,60,209
"5644",1133,941,2799,46,31,77
"5645",2140,2016,2800,42,46,88
"5646",2259,2211,2803,64,66,130
"5647",52,2348,2803,177,163,340
"5648",2229,2136,2803,34,31,65
"5649",2255,2152,2803,60,47,107
"5650",2143,2017,2804,48,52,100
"5651",2145,1959,2804,58,39,97
"5652",2225,2047,2804,98,87,185
"5653",2218,2059,2804,86,94,180
"5654",1805,1708,2809,101,98,199
"5655",1551,1339,2811,106,49,155
"5656",1308,1206,2817,36,36,72
"5657",1358,1246,2817,88,76,164
"5658",1624,1431,2817,232,181,413
"5659",2345,2042,2822,62,67,129
"5660",24,2048,2822,101,73,174
"5661",10,2101,2822,87,86,173
"5662",50,2147,2822,112,117,229
"5663",2332,2033,2822,39,43,82
"5664",2318,2024,2822,35,49,84
"5665",2328,2022,2822,45,47,92
"5666",1601,1326,2824,91,31,122
"5667",1828,1445,2827,88,90,178
"5668",1738,1350,2827,38,35,73
"5669",1746,1408,2827,46,53,99
"5670",1203,857,2829,105,97,202
"5671",1235,1117,2833,39,34,73
"5672",2005,1857,2834,164,168,332
"5673",1940,1814,2834,139,125,264
"5674",1840,1714,2840,35,36,71
"5675",1917,1754,2840,72,76,148
"5676",1919,1721,2840,74,43,117
"5677",1855,1732,2840,50,54,104
"5678",1826,1504,2841,104,101,205
"5679",1524,1352,2844,61,62,123
"5680",2024,1848,2873,31,43,74
"5681",2101,1911,2873,68,66,134
"5682",2057,1911,2873,64,66,130
"5683",2111,1938,2873,78,93,171
"5684",2339,2138,2873,226,213,439
"5685",1540,1342,2881,67,57,124
"5686",1533,1349,2881,60,64,124
"5687",1539,1350,2881,66,65,131
"5688",2006,1810,2882,45,40,85
"5689",2021,1836,2882,61,66,127
"5690",2002,1818,2882,42,48,90
"5691",2003,1808,2882,43,38,81
"5692",1,2026,2883,53,56,109
"5693",1314,1213,2895,47,43,90
"5694",1410,1318,2895,103,108,211
"5695",2048,1950,2902,136,130,266
"5696",2130,2037,2902,178,177,355
"5697",2117,2014,2907,59,54,113
"5698",2052,2006,2907,34,46,80
"5699",2108,2012,2907,50,52,102
"5700",2138,2047,2907,80,87,167
"5701",1913,1742,2920,60,49,109
"5702",1856,1725,2920,43,32,75
"5703",1917,1747,2920,53,43,96
"5704",1338,1128,2928,120,72,192
"5705",46,2204,2934,49,59,108
"5706",39,2139,2934,42,34,76
"5707",1707,1624,2936,43,52,95
"5708",1714,1624,2936,67,69,136
"5709",1704,1606,2936,40,34,74
"5710",1704,1612,2936,40,40,80
"5711",1728,1638,2936,64,66,130
"5712",2216,2042,2938,32,32,64
"5713",2242,2100,2938,58,50,108
"5714",135,4,2938,231,234,465
"5715",2241,2052,2938,57,42,99
"5716",1828,1659,2944,40,44,84
"5717",1845,1720,2944,42,50,92
"5718",1848,1722,2944,60,67,127
"5719",1843,1725,2944,55,70,125
"5720",1824,1657,2944,36,42,78
"5721",1643,1505,2945,43,40,83
"5722",2140,2030,2954,61,70,131
"5723",2136,2017,2954,57,57,114
"5724",2148,2036,2954,69,76,145
"5725",2220,2059,2954,101,99,200
"5726",2125,2013,2954,46,53,99
"5727",2118,2005,2954,39,45,84
"5728",2218,2101,2954,99,101,200
"5729",1521,1334,2962,98,60,158
"5730",1126,959,2967,54,64,118
"5731",1150,943,2967,78,48,126
"5732",2254,2136,2975,52,36,88
"5733",2311,2155,2975,69,55,124
"5734",2328,2214,2975,86,74,160
"5735",18,2300,2975,136,120,256
"5736",305,112,2976,243,242,485
"5737",117,2248,2976,135,98,233
"5738",1740,1436,2980,65,61,126
"5739",1706,1409,2980,31,34,65
"5740",1839,1540,2980,124,125,249
"5741",1240,1128,2996,40,42,82
"5742",1244,1131,2996,73,81,154
"5743",1507,1323,2998,49,33,82
"5744",1533,1337,2998,75,47,122
"5745",1649,1417,3004,69,67,136
"5746",1642,1414,3004,62,64,126
"5747",1631,1400,3004,51,50,101
"5748",2037,1935,3005,128,120,248
"5749",2130,2029,3005,181,174,355
"5750",2012,1902,3005,103,87,190
"5751",1501,1048,3008,54,38,92
"5752",1447,1041,3008,40,31,71
"5753",2321,2159,3016,110,119,229
"5754",2238,2102,3016,76,77,153
"5755",23,2224,3016,196,174,370
"5756",2158,2027,3016,51,57,108
"5757",58,2324,3016,231,234,465
"5758",2219,2048,3016,77,78,155
"5759",2232,2103,3016,85,93,178
"5760",2343,2210,3016,156,160,316
"5761",2118,1814,3018,34,44,78
"5762",2150,2042,3022,35,42,77
"5763",2158,2021,3022,58,36,94
"5764",2311,2155,3022,131,130,261
"5765",2247,2141,3022,107,116,223
"5766",2131,2017,3022,31,32,63
"5767",2223,2112,3022,83,87,170
"5768",2229,2117,3022,89,92,181
"5769",1255,923,3032,117,108,225
"5770",1248,910,3032,110,95,205
"5771",1918,1630,3033,205,130,335
"5772",1716,1539,3033,83,79,162
"5773",1744,1551,3033,111,91,202
"5774",1630,1454,3033,37,34,71
"5775",2400,2050,3036,40,39,79
"5776",40,2126,3036,80,75,155
"5777",2359,2046,3036,39,35,74
"5778",2400,2044,3036,40,33,73
"5779",32,2100,3036,72,49,121
"5780",2206,2021,3038,33,41,74
"5781",2319,2128,3038,106,108,214
"5782",2230,2044,3038,57,64,121
"5783",2231,2045,3038,58,65,123
"5784",2302,2114,3038,89,94,183
"5785",2243,2057,3038,70,77,147
"5786",2218,2035,3038,45,55,100
"5787",2208,2031,3038,35,51,86
"5788",2252,2059,3038,79,79,158
"5789",1207,1111,3041,46,51,97
"5790",2400,2104,3050,102,109,211
"5791",2306,2009,3050,48,54,102
"5792",2337,2039,3050,79,84,163
"5793",2359,2059,3050,101,104,205
"5794",1910,1440,3078,94,46,140
"5795",1827,1437,3078,51,43,94
"5796",1818,1427,3078,42,33,75
"5797",1818,1441,3078,42,47,89
"5798",1819,1433,3078,43,39,82
"5799",1913,1534,3078,97,100,197
"5800",1140,759,3083,33,34,67
"5801",1507,1233,3092,79,38,117
"5802",1449,1251,3092,56,56,112
"5803",1425,1238,3092,37,43,80
"5804",1431,1234,3092,43,39,82
"5805",1146,822,3096,42,47,89
"5806",1255,939,3096,111,124,235
"5807",1140,831,3096,36,56,92
"5808",2102,1934,3101,55,49,104
"5809",2108,1918,3101,61,33,94
"5810",2155,2015,3105,73,50,123
"5811",2202,2052,3105,80,87,167
"5812",2131,2017,3105,49,52,101
"5813",1218,1102,3119,45,42,87
"5814",1505,1349,3120,56,54,110
"5815",1517,1403,3120,68,68,136
"5816",2040,1901,3127,53,36,89
"5817",2104,1938,3127,72,73,145
"5818",2101,1925,3127,69,60,129
"5819",2116,1930,3127,84,65,149
"5820",2227,2049,3127,155,144,299
"5821",2352,2047,3137,64,67,131
"5822",2325,2012,3137,37,32,69
"5823",1957,1750,3150,122,112,234
"5824",1941,1642,3150,119,57,176
"5825",1923,1711,3150,101,86,187
"5826",1337,1202,3152,44,37,81
"5827",1739,1413,2782,45,43,88
"5828",1726,1410,2782,32,40,72
"5829",1749,1424,2782,55,54,109
"5830",1733,1416,2782,39,46,85
"5831",2231,2207,1126,81,77,158
"5832",1324,1021,1136,41,41,82
"5833",2358,2151,1139,55,56,111
"5834",1747,1537,1147,122,102,224
"5835",2031,1717,1149,52,35,87
"5836",2142,1853,1149,113,121,234
"5837",2032,1731,1149,53,49,102
"5838",2148,1816,1149,171,136,307
"5839",1204,1112,1151,122,117,239
"5840",1247,1150,1151,175,170,345
"5841",2002,1703,1152,145,148,293
"5842",45,2357,1153,62,57,119
"5843",101,22,1153,78,82,160
"5844",1621,1514,1157,44,54,98
"5845",1700,1529,1157,83,69,152
"5846",1614,1455,1157,37,35,72
"5847",1144,1013,1160,69,53,122
"5848",1834,1635,1162,63,65,128
"5849",3,2230,1172,83,100,183
"5850",2352,2151,1172,72,61,133
"5851",5,2227,1172,85,97,182
"5852",1645,1327,1173,36,32,68
"5853",1847,1518,1173,158,143,301
"5854",1121,845,1177,63,60,123
"5855",2317,2053,1179,112,118,230
"5856",2204,1937,1179,39,42,81
"5857",2217,1945,1179,52,50,102
"5858",1101,952,1180,41,47,88
"5859",1116,948,1180,51,43,94
"5860",1102,944,1180,42,39,81
"5861",1132,936,1180,67,31,98
"5862",1109,950,1180,44,45,89
"5863",1106,950,1180,41,45,86
"5864",1110,937,1180,45,32,77
"5865",1113,1001,1180,53,56,109
"5866",1503,1125,1182,51,50,101
"5867",1928,1816,1185,59,36,95
"5868",1926,1837,1185,57,57,114
"5869",1735,1404,1186,68,69,137
"5870",1650,1341,1187,43,58,101
"5871",1507,1306,1187,55,61,116
"5872",1900,1754,1188,115,94,209
"5873",1749,1716,1188,44,56,100
"5874",1426,1222,1190,46,47,93
"5875",1534,1312,1191,122,102,224
"5876",1937,1900,1193,93,85,178
"5877",1936,1853,1193,92,78,170
"5878",1317,1158,1197,60,33,93
"5879",1657,1411,1198,75,66,141
"5880",1640,1402,1198,58,57,115
"5881",1758,1516,1198,136,131,267
"5882",301,16,1133,184,191,375
"5883",233,2349,1133,156,164,320
"5884",1748,1529,1130,101,39,140
"5885",1705,1446,4489,50,42,92
"5886",1923,1808,1102,41,33,74
"5887",1948,1824,1102,66,49,115
"5888",2006,1829,1123,74,49,123
"5889",1629,1439,1147,64,64,128
"5890",1709,1444,1147,84,49,133
"5891",1325,1131,1145,33,31,64
"5892",1337,1147,1145,45,52,97
"5893",1707,1343,1142,40,53,93
"5894",2025,1813,1102,103,38,141
"5895",38,2217,1139,95,82,177
"5896",15,2139,1139,72,44,116
"5897",1645,1525,1130,38,35,73
"5898",1712,1535,1130,65,45,110
"5899",1652,1531,1130,45,41,86
"5900",1702,1403,5800,59,63,122
"5901",1640,1331,5800,37,31,68
"5902",1938,1613,5800,215,193,408
"5903",1818,1433,5801,380,343,723
"5904",1309,1012,5801,71,82,153
"5905",1424,1228,5801,101,103,204
"5906",949,856,5803,47,41,88
"5907",2236,2205,1126,86,75,161
"5908",2227,2127,1126,77,37,114
"5909",2321,2012,1117,44,52,96
"5910",53,2049,1113,111,104,215
"5911",2158,2125,1113,34,35,69
"5912",1936,1848,1115,66,68,134
"5913",2252,2147,1112,50,47,97
"5914",45,2055,1113,103,110,213
"5915",2118,1806,5807,161,151,312
"5916",2201,1825,5807,204,170,374
"5917",2012,1845,5810,57,45,102
"5918",1811,1451,5814,43,41,84
"5919",1924,1553,5814,116,103,219
"5920",2300,2147,5816,50,52,102
"5921",2254,2135,5816,44,40,84
"5922",2242,2113,5816,230,213,443
"5923",2327,2021,5817,58,61,119
"5924",50,2121,5817,91,76,167
"5925",2350,2039,5817,31,34,65
"5926",37,2125,5817,78,80,158
"5927",37,2131,5817,78,86,164
"5928",8,2104,5817,49,59,108
"5929",232,107,5819,235,227,462
"5930",2318,2156,5819,36,36,72
"5931",1741,1521,5821,81,66,147
"5932",1746,1529,5821,86,74,160
"5933",1752,1546,5821,92,91,183
"5934",1713,1457,5821,53,42,95
"5935",1809,1603,5821,109,108,217
"5936",1455,1225,5823,70,60,130
"5937",2109,1932,5826,62,47,109
"5938",2134,1954,5838,87,69,156
"5939",1049,945,5839,142,135,277
"5940",910,807,5839,43,37,80
"5941",914,811,5839,52,41,93
"5942",924,805,5839,57,35,92
"5943",914,806,5839,47,36,83
"5944",941,822,5839,74,52,126
"5945",1530,1216,5840,92,101,193
"5946",2019,1721,5847,51,51,102
"5947",1007,709,6997,96,69,165
"5948",2350,2000,7037,64,65,129
"5949",5,2009,7037,79,74,153
"5950",2146,1930,230,106,120,226
"5951",2047,1815,230,47,45,92
"5952",2122,1836,230,82,66,148
"5953",2149,1925,230,109,115,224
"5954",1702,1538,370,481,490,971
"5955",1856,1515,552,46,61,107
"5956",1654,1534,801,162,171,333
"5957",1218,1029,855,63,91,154
"5958",1909,1705,855,474,487,961
"5959",1620,1301,1697,50,56,106
"5960",1631,1322,1697,61,77,138
"5961",1959,1642,1978,51,62,113
"5962",1400,1305,270,433,425,858
"5963",1011,919,362,53,69,122
"5964",1449,1306,963,64,71,135
"5965",949,858,1628,79,78,157
"5966",1303,1134,778,73,74,147
"5967",2343,2221,2725,38,66,104
"5968",1624,1519,464,39,39,78
"5969",2007,1913,1286,47,53,100
"5970",1538,1456,862,48,61,109
"5971",2004,1857,681,34,57,91
"5972",1232,1110,708,37,45,82
"5973",1754,1712,3805,54,57,111
"5974",1813,1627,1217,58,62,120
"5975",2306,1924,3188,76,89,165
"5976",2254,2203,2957,119,123,242
"5977",1843,1720,1869,38,45,83
"5978",1549,1503,3688,39,53,92
"5979",1035,931,2933,35,41,76
"5980",2139,2012,2045,89,112,201
"5981",2156,2102,2564,86,92,178
"5982",2045,1951,2690,65,71,136
"5983",1429,1317,1203,74,82,156
"5984",2303,2150,5008,113,135,248
"5985",1423,1335,3964,148,155,303
"5986",1916,1833,18,31,38,69
"5987",1644,1549,36,49,49,98
"5988",1036,928,1695,46,68,114
"5989",1723,1618,1899,33,38,71
"5990",1321,1206,570,91,101,192
"5991",2030,1919,676,35,54,89
"5992",2355,2146,806,45,56,101
"5993",1458,1413,1442,58,58,116
"5994",1024,941,2025,39,41,80
"5995",2321,2152,1930,96,102,198
"5996",1041,904,975,46,59,105
"5997",2357,2006,47,32,41,73
"5998",1640,1239,1106,75,69,144
"5999",2303,1920,1919,73,90,163
"6000",1517,1202,1164,57,62,119
"6001",945,859,1628,75,79,154
"6002",1610,1516,34,40,46,86
"6003",2031,1938,52,31,38,69
"6004",2205,2103,58,40,33,73
"6005",2323,2228,60,88,88,176
"6006",1300,1138,778,70,78,148
"6007",1802,1634,3675,32,34,66
"6008",1447,1315,19,47,50,97
"6009",1524,1202,9,94,87,181
"6010",22,2054,1778,52,39,91
"6011",1712,1407,23,37,42,79
"6012",1112,1016,3,77,81,158
"6013",1603,1504,27,38,39,77
"6014",2243,2143,854,53,53,106
"6015",1054,952,1,74,82,156
"6016",2208,2059,1401,48,49,97
"6017",2301,2000,43,91,90,181
"6018",2028,1922,676,33,57,90
"6019",24,2315,776,94,110,204
"6020",1815,1653,1752,60,88,148
"6021",113,2348,2725,128,153,281
"6022",2213,2100,1861,118,120,238
"6023",1106,945,1469,41,45,86
"6024",2053,1932,1655,73,77,150
"6025",1536,1222,5,171,167,338
"6026",4,2056,49,44,46,90
"6027",2008,1638,401,53,33,86
"6028",1622,1304,502,87,84,171
"6029",1134,826,931,49,56,105
"6030",1330,1037,949,105,77,182
"6031",1737,1525,1352,137,150,287
"6032",1239,1136,11,34,31,65
"6033",2232,2119,1179,82,69,151
"6034",2104,1952,1286,104,92,196
"6035",1448,1321,1639,88,61,149
"6036",2238,2044,1727,38,64,102
"6037",1259,1102,1223,74,37,111
"6038",2151,1746,37,31,41,72
"6039",2045,1958,1040,40,53,93
"6040",2002,1851,681,32,51,83
"6041",1310,1143,708,75,78,153
"6042",2320,2224,757,60,59,119
"6043",1701,1611,915,51,56,107
"6044",1221,1124,3840,96,94,190
"6045",1338,1143,7,108,108,216
"6046",2319,2134,215,94,104,198
"6047",2057,1912,1296,197,207,404
"6048",1946,1632,31,71,57,128
"6049",1202,908,201,67,73,140
"6050",1744,1625,3654,99,105,204
"6051",2253,2209,1565,53,54,107
"6052",2237,1845,1919,47,55,102
"6053",2025,1939,41,100,104,204
"6054",1406,1311,24,71,71,142
"6055",1432,1335,28,32,35,67
"6056",1520,1421,30,55,51,106
"6057",1703,1611,34,93,101,194
"6058",1659,1603,36,64,63,127
"6059",2031,1936,906,71,76,147
"6060",122,2230,43,232,240,472
"6061",1122,805,931,37,35,72
"6062",1601,1328,1352,41,33,74
"6063",2020,1925,1286,60,65,125
"6064",1718,1458,228,303,303,606
"6065",38,2032,37,198,207,405
"6066",2226,2145,2539,36,55,91
"6067",1647,1601,915,37,46,83
"6068",1850,1803,511,70,68,138
"6069",1555,1504,1442,115,109,224
"6070",1308,1145,3056,33,45,78
"6071",2320,1912,1919,90,82,172
"6072",1714,1620,1095,59,55,114
"6073",1704,1608,38,34,38,72
"6074",1933,1839,48,33,39,72
"6075",2245,2124,51,45,59,104
"6076",41,2132,1778,71,77,148
"6077",1959,1909,864,89,99,188
"6078",20,2132,43,170,182,352
"6079",1827,1703,1752,72,98,170
"6080",1953,1731,33,83,86,169
"6081",2317,1907,37,117,122,239
"6082",1717,1559,3654,72,79,151
"6083",1250,1000,375,32,45,77
"6084",1714,1417,2242,38,44,82
"6085",1225,925,1235,135,145,280
"6086",1053,752,1248,108,112,220
"6087",1054,759,1235,44,59,103
"6088",1851,1535,2242,135,122,257
"6089",1722,1426,2242,46,53,99
"6090",1114,818,4996,133,138,271
"6091",1428,1137,5122,62,67,129
"6092",1420,1128,5122,54,58,112
"6093",1430,1125,5122,64,55,119
"6094",1401,1104,5122,35,34,69
"6095",1449,1202,5122,83,92,175
"6096",1434,1154,5122,68,84,152
"6097",1509,1217,5122,103,107,210
"6098",1418,1118,5122,52,48,100
"6099",1535,1244,5122,129,134,263
"6100",2228,1944,5183,82,103,185
"6101",2,2054,5183,176,173,349
"6102",2138,1854,5183,32,53,85
"6103",2316,2002,5183,130,121,251
"6104",2225,1932,5183,79,91,170
"6105",7,2113,5183,181,192,373
"6106",2019,1731,5190,85,95,180
"6107",1958,1651,5190,64,55,119
"6108",2105,1730,5190,131,94,225
"6109",2141,1853,5190,158,168,326
"6110",2022,1728,5190,88,92,180
"6111",2054,1749,5190,120,113,233
"6112",2113,1821,5190,139,145,284
"6113",1959,1713,5190,65,77,142
"6114",2016,1730,5190,82,94,176
"6115",2126,1733,5190,152,97,249
"6116",1309,1016,5201,57,61,118
"6117",1244,955,5225,47,50,97
"6118",1452,1118,5225,175,133,308
"6119",1344,1051,5225,107,106,213
"6120",1325,1038,5225,88,93,181
"6121",1427,1137,5225,150,152,302
"6122",1424,1240,5402,58,50,108
"6123",1500,1324,5402,94,94,188
"6124",1506,1340,5402,100,110,210
"6125",2019,1901,5441,141,161,302
"6126",1847,1654,5441,49,34,83
"6127",1831,1652,5441,33,32,65
"6128",2044,1842,5441,166,142,308
"6129",1910,1743,5441,72,83,155
"6130",1924,1754,5441,86,94,180
"6131",1926,1804,5441,88,104,192
"6132",1103,817,5445,64,77,141
"6133",1156,905,5445,117,125,242
"6134",1156,908,5445,117,128,245
"6135",2051,1730,5525,143,172,315
"6136",2008,1635,5525,100,117,217
"6137",1943,1601,5525,75,83,158
"6138",1935,1525,5525,67,47,114
"6139",1315,935,5526,119,130,249
"6140",1249,909,5526,93,104,197
"6141",1801,1634,145,51,45,96
"6142",1824,1622,145,74,32,106
"6143",1800,1637,145,50,47,97
"6144",2106,1941,229,36,31,67
"6145",43,2017,292,243,152,395
"6146",50,2103,296,150,93,243
"6147",1036,751,290,86,96,182
"6148",2119,1821,292,39,32,71
"6149",2005,1606,288,118,54,172
"6150",1328,1045,290,258,270,528
"6151",2123,1838,292,43,49,92
"6152",2142,2039,2870,122,134,256
"6153",2028,1857,2870,48,32,80
"6154",2142,2036,2870,122,131,253
"6155",2032,1903,2870,52,38,90
"6156",1228,1115,2958,58,55,113
"6157",1349,1236,2958,134,131,265
"6158",1254,1133,2958,79,68,147
"6159",1229,1131,2958,54,66,120
"6160",1207,1101,3210,137,141,278
"6161",1158,1016,3210,128,96,224
"6162",1131,1006,3210,101,86,187
"6163",1559,1458,3216,179,188,367
"6164",1530,1403,3216,150,133,283
"6165",1509,1355,3216,129,125,254
"6166",2003,1742,3216,423,352,775
"6167",2207,2058,3328,82,83,165
"6168",5,2259,3328,200,204,404
"6169",2203,2046,3328,78,71,149
"6170",1642,1533,3390,37,38,75
"6171",1759,1645,3390,114,110,224
"6172",1708,1544,3390,63,49,112
"6173",1638,1532,3390,33,37,70
"6174",2326,1949,3717,146,84,230
"6175",2152,1924,3717,52,59,111
"6176",103,2109,3717,243,164,407
"6177",2220,1926,3717,80,61,141
"6178",2242,1937,3717,102,72,174
"6179",1518,1346,3719,53,56,109
"6180",1605,1434,3719,100,104,204
"6181",1513,1326,3719,48,36,84
"6182",1502,1324,3719,37,34,71
"6183",2220,2033,3724,55,48,103
"6184",2249,2113,3724,84,88,172
"6185",1228,1108,3762,183,203,386
"6186",1912,1638,3786,77,68,145
"6187",2131,1845,3786,181,175,356
"6188",2122,1837,3786,172,167,339
"6189",2008,1735,3786,98,105,203
"6190",1924,1653,3786,54,63,117
"6191",2351,2033,3786,321,283,604
"6192",1950,1634,3786,80,44,124
"6193",1917,1630,3786,47,40,87
"6194",1601,1326,3796,151,141,292
"6195",1500,1246,3796,70,86,156
"6196",1504,1231,3796,74,71,145
"6197",1708,1410,3796,198,170,368
"6198",1459,1250,3796,69,90,159
"6199",1441,1155,3796,51,35,86
"6200",1557,1310,3796,127,110,237
"6201",1555,1318,3796,125,118,243
"6202",1511,1219,3796,81,59,140
"6203",1520,1251,3796,90,91,181
"6204",951,714,3859,41,34,75
"6205",1019,739,3859,69,59,128
"6206",2224,2116,426,69,71,140
"6207",2157,2054,426,42,49,91
"6208",2301,2158,426,106,113,219
"6209",2231,2125,426,76,80,156
"6210",130,2359,426,255,234,489
"6211",2209,2042,426,54,37,91
"6212",2201,2057,426,46,52,98
"6213",53,2133,1294,223,228,451
"6214",2150,1831,1294,40,46,86
"6215",1645,1539,1566,95,99,194
"6216",1550,1435,1566,40,35,75
"6217",1819,1551,1566,189,111,300
"6218",1725,1630,1566,135,150,285
"6219",1401,1248,1698,41,43,84
"6220",1421,1252,1698,61,47,108
"6221",1401,1251,1698,41,46,87
"6222",1620,1311,1698,180,66,246
"6223",1403,1304,1698,43,59,102
"6224",1816,1722,1925,36,52,88
"6225",1815,1718,1925,35,48,83
"6226",1819,1716,1925,39,46,85
"6227",1902,1723,1925,82,53,135
"6228",1820,1710,1925,40,40,80
"6229",2039,1918,1925,179,168,347
"6230",1136,1020,2002,81,75,156
"6231",1440,1134,2234,45,64,109
"6232",2158,1913,731,52,43,95
"6233",2205,1925,731,59,55,114
"6234",2123,1604,622,87,47,134
"6235",2312,1810,622,196,173,369
"6236",2045,1620,622,49,63,112
"6237",2212,1758,622,136,161,297
"6238",1225,741,620,59,41,100
"6239",2045,1552,622,49,35,84
"6240",2052,1609,622,56,52,108
"6241",2150,1655,622,114,98,212
"6242",2044,1611,622,48,54,102
"6243",2052,1716,244,82,91,173
"6244",1900,1616,246,48,46,94
"6245",1436,1216,270,66,51,117
"6246",1552,1502,320,39,37,76
"6247",1902,1626,370,138,111,249
"6248",1644,1242,409,60,52,112
"6249",2356,2110,616,42,49,91
"6250",1746,1517,746,41,47,88
"6251",2351,2020,1488,37,55,92
"6252",1331,1011,1,36,36,72
"6253",2141,2028,297,75,83,158
"6254",1544,1123,408,194,213,407
"6255",1216,815,776,36,55,91
"6256",2311,1951,1586,45,44,89
"6257",1843,1510,1850,98,110,208
"6258",1835,1553,146,167,158,325
"6259",2232,2014,344,81,104,185
"6260",1243,946,346,83,61,144
"6261",5,2000,426,35,40,75
"6262",2102,1628,532,200,203,403
"6263",1611,1332,546,116,107,223
"6264",1853,1638,746,108,128,236
"6265",2019,1744,1546,75,74,149
"6266",1536,1241,1646,166,141,307
"6267",1641,1459,1695,110,104,214
"6268",1942,1831,397,50,56,106
"6269",1514,1406,738,90,96,186
"6270",29,2215,209,31,40,71
"6271",1857,1617,246,45,47,92
"6272",1448,1201,267,47,31,78
"6273",1420,1203,270,50,38,88
"6274",2059,2004,297,33,59,92
"6275",1213,923,309,66,38,104
"6276",2345,1900,394,71,65,136
"6277",1632,1236,409,48,46,94
"6278",1956,1921,520,42,61,103
"6279",1837,1410,532,55,65,120
"6280",2150,1654,682,75,69,144
"6281",1418,1059,686,31,34,65
"6282",2003,1903,763,121,128,249
"6283",1820,1546,767,66,61,127
"6284",1605,1231,1448,126,121,247
"6285",2304,1952,1586,55,62,117
"6286",19,1917,1632,122,92,214
"6287",2123,1919,1706,85,89,174
"6288",2108,1944,1795,100,104,204
"6289",2354,2046,190,68,87,155
"6290",1856,1417,326,110,77,187
"6291",2200,1904,344,52,34,86
"6292",1956,1847,397,61,72,133
"6293",1821,1406,409,157,136,293
"6294",2300,2025,444,67,70,137
"6295",2033,1939,479,31,34,65
"6296",1833,1403,482,41,63,104
"6297",1948,1530,532,126,145,271
"6298",2051,1646,558,44,41,85
"6299",2351,2107,616,43,52,95
"6300",2326,1944,644,51,49,100
"6301",2150,1700,682,75,75,150
"6302",9,1929,732,50,39,89
"6303",200,2356,752,148,156,304
"6304",49,2149,775,159,169,328
"6305",2342,1849,1540,68,54,122
"6306",57,2224,1616,69,74,143
"6307",2338,1848,1632,81,63,144
"6308",2146,1726,1676,74,86,160
"6309",2101,1931,1826,36,31,67
"6310",1837,1412,1832,145,157,302
"6311",1846,1437,1836,113,129,242
"6312",1828,1421,1850,83,61,144
"6313",2136,1957,1891,41,37,78
"6314",1843,1521,146,175,126,301
"6315",1931,1607,246,79,37,116
"6316",152,2141,401,32,46,78
"6317",1347,945,406,133,125,258
"6318",1,2028,444,128,73,201
"6319",149,2327,467,117,127,244
"6320",1644,1359,546,146,134,280
"6321",2341,2228,597,80,88,168
"6322",2348,1936,644,73,41,114
"6323",1847,1528,746,102,58,160
"6324",1929,1736,850,45,31,76
"6325",2246,2146,1423,36,41,77
"6326",2312,2215,1479,66,65,131
"6327",2329,2244,1533,88,94,182
"6328",2324,2001,1546,260,211,471
"6329",1424,1136,1646,91,76,167
"6330",1217,933,1746,134,128,262
"6331",1947,1547,326,161,167,328
"6332",1830,1347,532,48,42,90
"6333",2121,1640,632,46,45,91
"6334",2237,2145,820,58,50,108
"6335",1129,812,1590,31,37,68
"6336",2313,2155,1597,44,55,99
"6337",104,2045,62,355,380,735
"6338",1959,1555,407,67,65,132
"6339",1554,1107,432,43,37,80
"6340",1826,1407,532,44,62,106
"6341",2245,1759,632,130,124,254
"6342",2258,1711,682,143,86,229
"6343",23,1924,732,64,34,98
"6344",1810,1535,767,56,50,106
"6345",20,1850,1706,123,65,188
"6346",7,1958,1776,32,43,75
"6347",2003,1819,59,56,44,100
"6348",1950,1521,62,41,56,97
"6349",2130,1948,150,83,68,151
"6350",141,2302,344,273,272,545
"6351",40,2155,444,167,160,327
"6352",2036,1936,479,34,31,65
"6353",15,2215,489,73,80,153
"6354",1524,1203,586,264,258,522
"6355",29,2210,620,57,50,107
"6356",2101,1806,667,70,41,111
"6357",1140,846,706,59,71,130
"6358",1952,1745,850,68,40,108
"6359",118,2121,1488,95,91,186
"6360",1828,1718,1497,82,93,175
"6361",2027,1703,1546,83,33,116
"6362",29,2301,1597,120,121,241
"6363",2013,1916,1603,67,60,127
"6364",120,2204,1616,92,54,146
"6365",2319,2156,1717,40,41,81
"6366",2332,1958,1748,54,48,102
"6367",1349,1237,197,40,41,81
"6368",1256,1210,220,177,180,357
"6369",2125,1737,412,31,37,68
"6370",1924,1834,520,58,49,107
"6371",1702,1438,546,167,173,340
"6372",2027,1825,570,36,45,81
"6373",36,1943,582,61,53,114
"6374",2025,1800,667,37,35,72
"6375",2308,2000,1586,62,70,132
"6376",1944,1856,1603,32,31,63
"6377",1353,1221,1605,34,31,65
"6378",1500,1050,1753,141,125,266
"6379",1935,1833,5,43,48,91
"6380",1744,1616,33,64,45,109
"6381",2250,2053,47,125,103,228
"6382",2100,1807,59,113,32,145
"6383",2206,2003,150,170,138,308
"6384",1633,1100,212,58,40,98
"6385",2354,2017,250,61,67,128
"6386",1422,1206,270,52,41,93
"6387",2206,1918,344,58,48,106
"6388",2157,2052,479,115,107,222
"6389",1910,1357,482,78,57,135
"6390",57,2218,489,115,83,198
"6391",18,2052,500,93,87,180
"6392",2100,1904,520,106,44,150
"6393",1354,1217,659,41,37,78
"6394",2157,1630,682,82,45,127
"6395",36,2206,752,64,46,110
"6396",2353,2141,815,72,36,108
"6397",2322,2205,820,103,70,173
"6398",1928,1745,850,44,40,84
"6399",11,2007,1417,53,42,95
"6400",2302,2155,1423,52,50,102
"6401",2141,1933,1475,364,308,672
"6402",2245,1847,1558,44,47,91
"6403",26,1936,1632,129,111,240
"6404",7,2146,1644,52,31,83
"6405",1450,1139,1656,36,34,70
"6406",2355,2151,1717,76,36,112
"6407",1130,1015,1723,36,45,81
"6408",21,2001,1776,46,46,92
"6409",1854,1647,1787,116,61,177
"6410",2153,2035,1826,88,95,183
"6411",2155,1720,62,166,175,341
"6412",2120,1648,210,42,58,100
"6413",1435,1000,232,36,40,76
"6414",1907,1400,482,75,60,135
"6415",1844,1358,532,62,53,115
"6416",15,1939,582,37,49,86
"6417",2115,1654,632,40,59,99
"6418",2157,2003,670,38,63,101
"6419",2235,1737,682,120,112,232
"6420",2048,1807,709,54,37,91
"6421",57,2021,732,98,91,189
"6422",27,1945,1706,130,120,250
"6423",2011,1838,59,64,63,127
"6424",2014,1851,150,58,66,124
"6425",2110,1635,210,32,45,77
"6426",1504,1036,232,65,76,141
"6427",1859,1626,246,47,56,103
"6428",1907,1414,482,75,74,149
"6429",105,2030,582,87,100,187
"6430",2136,1705,632,61,70,131
"6431",2259,1747,682,144,122,266
"6432",32,1957,732,73,67,140
"6433",13,2044,1488,59,79,138
"6434",4,1931,1632,107,106,213
"6435",2025,1827,1889,35,42,77
"6436",1522,1043,232,83,83,166
"6437",22,1932,310,43,32,75
"6438",1943,1704,370,179,149,328
"6439",1654,1159,432,103,89,192
"6440",2339,2208,442,68,63,131
"6441",2137,1636,482,225,216,441
"6442",1932,1453,532,110,108,218
"6443",2048,1830,570,54,50,104
"6444",148,2048,582,130,118,248
"6445",2258,1809,632,143,134,277
"6446",2318,1942,644,43,47,90
"6447",2240,2001,670,81,61,142
"6448",3,1905,682,208,200,408
"6449",11,2005,732,52,75,127
"6450",1925,1740,850,41,35,76
"6451",33,1955,1632,136,130,266
"6452",1949,1711,1750,98,71,169
"6453",1751,1301,1832,99,86,185
"6454",1738,1622,33,58,51,109
"6455",1734,1632,35,65,57,122
"6456",2006,1829,150,50,44,94
"6457",1622,1156,232,143,156,299
"6458",1401,1156,270,31,31,62
"6459",40,2022,310,61,82,143
"6460",1454,1023,332,154,158,312
"6461",1733,1517,370,49,42,91
"6462",2018,1623,407,86,93,179
"6463",1646,1216,432,95,106,201
"6464",1929,1348,482,97,48,145
"6465",2014,1523,532,152,138,290
"6466",110,2020,582,92,90,182
"6467",1745,1616,589,60,51,111
"6468",2341,2104,670,142,124,266
"6469",1,1903,682,206,198,404
"6470",2253,1922,1586,44,32,76
"6471",135,2304,1645,145,124,269
"6472",1928,1831,1779,46,46,92
"6473",1745,1257,1832,93,82,175
"6474",1853,1615,146,185,180,365
"6475",1816,1642,275,56,52,108
"6476",2101,2006,479,59,61,120
"6477",2255,2153,511,44,53,97
"6478",2148,1656,682,73,71,144
"6479",1629,1505,697,41,35,76
"6480",1107,919,799,53,34,87
"6481",2220,2138,820,41,43,84
"6482",2145,2056,1441,54,56,110
"6483",1432,1141,1786,102,81,183
"6484",2012,1546,62,71,81,152
"6485",2138,1856,146,353,341,694
"6486",1928,1650,246,79,80,159
"6487",1807,1647,275,47,57,104
"6488",1225,929,346,65,44,109
"6489",2250,1954,444,60,39,99
"6490",1259,1034,542,52,39,91
"6491",1621,1333,546,126,108,234
"6492",13,1921,582,38,31,69
"6493",1930,1649,746,148,139,287
"6494",1402,1132,1646,72,72,144
"6495",1653,1502,137,58,42,100
"6496",1915,1640,146,207,205,412
"6497",1948,1539,158,63,54,117
"6498",1637,1115,212,62,55,117
"6499",2238,1913,246,266,223,489
"6500",1513,1313,270,103,108,211
"6501",1800,1356,326,54,56,110
"6502",2247,2011,344,99,101,200
"6503",1937,1533,407,45,43,88
"6504",2105,1936,417,34,31,65
"6505",2339,2023,444,106,68,174
"6506",1728,1329,458,33,34,67
"6507",1352,1238,499,44,53,97
"6508",2005,1913,520,51,53,104
"6509",1526,1242,546,68,57,125
"6510",1716,1545,599,91,90,181
"6511",1623,1513,623,41,38,79
"6512",2059,1803,746,234,213,447
"6513",2127,2043,1441,45,53,98
"6514",1600,1132,1476,67,62,129
"6515",2319,2233,1533,78,83,161
"6516",1731,1647,1541,136,142,278
"6517",1432,1059,1544,34,44,78
"6518",1835,1525,1562,118,115,233
"6519",2109,1946,1604,44,46,90
"6520",1312,1229,1620,43,49,92
"6521",2310,2151,1717,31,36,67
"6522",1931,1840,1779,49,55,104
"6523",1647,1516,1821,33,36,69
"6524",1755,1357,1850,50,37,87
"6525",2052,1834,5,120,49,169
"6526",2100,1953,33,260,262,522
"6527",2311,2153,47,146,163,309
"6528",2237,2121,59,210,226,436
"6529",946,843,128,66,71,137
"6530",1702,1516,137,67,56,123
"6531",2220,2055,150,184,190,374
"6532",1932,1530,158,47,45,92
"6533",204,2227,190,198,188,386
"6534",1350,1209,197,59,34,93
"6535",239,19,209,161,164,325
"6536",2325,1759,210,167,129,296
"6537",2259,1905,244,209,200,409
"6538",2257,2027,246,285,297,582
"6539",203,2213,250,186,183,369
"6540",1500,1202,267,59,32,91
"6541",1831,1711,275,68,81,149
"6542",2309,2155,297,163,170,333
"6543",2357,2219,299,97,84,181
"6544",152,2133,310,133,153,286
"6545",1607,1509,320,54,44,98
"6546",2140,1903,344,32,33,65
"6547",2359,2205,359,90,65,155
"6548",1734,1510,370,50,35,85
"6549",2254,2143,397,239,248,487
"6550",342,2334,401,142,159,301
"6551",2339,2158,417,188,173,361
"6552",2214,2106,423,76,76,152
"6553",305,2306,426,215,226,441
"6554",12,2232,442,101,87,188
"6555",208,2350,467,136,150,286
"6556",2148,2051,479,106,106,212
"6557",2356,2139,489,54,44,98
"6558",1738,1510,509,41,35,76
"6559",17,2302,511,126,122,248
"6560",1958,1851,520,44,31,75
"6561",229,2354,567,255,254,509
"6562",2304,2158,597,43,58,101
"6563",1643,1510,599,58,55,113
"6564",2259,1922,606,250,217,467
"6565",17,2146,616,69,91,160
"6566",2114,1639,632,39,44,83
"6567",142,2203,644,187,188,375
"6568",242,2247,658,221,222,443
"6569",2221,1958,667,150,153,303
"6570",2305,2047,670,106,107,213
"6571",1,1902,682,206,197,403
"6572",2144,1847,709,110,77,187
"6573",103,2027,732,104,97,201
"6574",1749,1513,746,44,43,87
"6575",25,2206,752,53,46,99
"6576",2158,2040,763,236,225,461
"6577",41,2324,815,120,139,259
"6578",42,2057,1417,80,92,172
"6579",27,2325,1423,137,140,277
"6580",2333,2241,1441,171,171,342
"6581",2342,2230,1479,96,80,176
"6582",139,2156,1488,145,151,296
"6583",2145,2018,1497,279,273,552
"6584",2358,2306,1533,117,116,233
"6585",205,2136,1540,211,221,432
"6586",233,22,1546,449,472,921
"6587",2338,2008,1552,80,78,158
"6588",58,2115,1558,177,195,372
"6589",1346,1132,1583,206,127,333
"6590",205,2230,1586,236,220,456
"6591",1703,1537,1589,43,37,80
"6592",203,2214,1602,205,184,389
"6593",2134,2036,1603,167,161,328
"6594",221,17,1616,153,187,340
"6595",1332,1217,1620,63,37,100
"6596",1735,1539,1621,112,69,181
"6597",6,2200,1644,51,45,96
"6598",133,2338,1645,143,158,301
"6599",1324,1058,1646,31,38,69
"6600",2348,2012,1648,276,267,543
"6601",107,2136,1662,163,146,309
"6602",26,2016,1676,234,256,490
"6603",1245,1132,1679,150,137,287
"6604",2107,1718,1688,65,68,133
"6605",2033,1927,1689,95,112,207
"6606",2359,1845,1706,102,60,162
"6607",2353,2230,1717,74,75,149
"6608",2143,1858,1750,212,178,390
"6609",1,2227,1757,317,322,639
"6610",7,2001,1776,32,46,78
"6611",2150,2010,1795,142,130,272
"6612",110,2257,1812,109,112,221
"6613",1712,1532,1821,58,52,110
"6614",3,2230,1826,218,210,428
"6615",23,2047,1830,91,83,174
"6616",32,2223,1889,282,278,560
"6617",2244,2106,1891,109,106,215
"6618",2336,2022,190,50,63,113
"6619",1734,1512,370,50,37,87
"6620",2313,1956,444,80,41,121
"6621",2113,1842,570,79,62,141
"6622",2344,2014,644,69,79,148
"6623",2213,1931,670,54,31,85
"6624",2329,2144,815,48,39,87
"6625",1157,1004,1407,37,49,86
"6626",2222,2023,1475,405,358,763
"6627",2013,1723,1546,69,53,122
"6628",1815,1501,1562,98,91,189
"6629",2254,1935,1586,45,45,90
"6630",2314,2149,1597,45,49,94
"6631",2344,1914,1632,87,89,176
"6632",2302,1954,1662,38,44,82
"6633",2025,1841,1689,87,66,153
"6634",1134,926,1746,91,121,212
"6635",23,2059,1748,105,109,214
"6636",2137,1918,1787,279,212,491
"6637",1924,1448,106,235,243,478
"6638",2215,1808,412,81,68,149
"6639",2243,2201,820,64,66,130
"6640",2359,2016,1417,37,51,88
"6641",1231,1102,1470,42,67,109
"6642",2330,1901,1632,73,76,149
"6643",2002,1841,150,46,56,102
"6644",1716,1527,370,32,52,84
"6645",1300,1105,542,54,70,124
"6646",2337,1951,658,36,46,82
"6647",2356,2031,1488,42,66,108
"6648",1710,1413,1562,33,43,76
"6649",2037,1648,1688,35,38,73
"6650",1502,1355,323,40,40,80
"6651",2211,2101,423,56,51,107
"6652",2049,1944,479,47,39,86
"6653",2251,2035,567,37,55,92
"6654",1943,1636,1536,33,46,79
"6655",2306,1845,1540,32,50,82
"6656",2232,1839,1558,31,39,70
"6657",2008,1912,1603,62,56,118
"6658",2109,1731,1688,67,81,148
"6659",1237,958,1746,157,153,310
"6660",1924,1715,1750,73,75,148
"6661",20,2110,1830,42,60,102
"6662",1705,1612,6,36,42,78
"6663",2347,2144,770,40,44,84
"6664",1945,1823,59,38,48,86
"6665",2102,1659,62,113,154,267
"6666",1621,1447,599,36,32,68
"6667",1622,1521,1541,67,56,123
"6668",2319,2008,1552,61,78,139
"6669",1911,1605,1658,31,35,66
"6670",1636,1310,1790,31,35,66
"6671",2026,1904,1795,58,64,122
"6672",34,2049,426,64,89,153
"6673",1734,1432,786,41,57,98
"6674",1949,1816,150,33,31,64
"6675",2129,2033,423,31,43,74
"6676",32,2156,467,40,36,76
"6677",1830,1400,482,38,60,98
"6678",51,1955,582,73,65,138
"6679",2134,1635,632,59,40,99
"6680",2104,1802,667,73,37,110
"6681",2255,1811,682,140,146,286
"6682",2337,2237,1423,87,92,179
"6683",1722,1607,6,50,37,87
"6684",1714,1623,35,45,48,93
"6685",2306,2006,775,56,66,122
"6686",1932,1841,1779,50,56,106
"6687",1731,1327,326,36,37,73
"6688",2007,1856,397,47,56,103
"6689",1859,1427,532,74,77,151
"6690",2100,1754,606,136,134,270
"6691",2045,1807,709,51,37,88
"6692",2334,2159,815,48,49,97
"6693",1308,1052,1470,99,77,176
"6694",2311,1821,1540,42,31,73
"6695",55,2258,1644,100,103,203
"6696",1403,1055,1646,70,35,105
"6697",2334,2033,1662,65,78,143
"6698",2142,1749,1688,100,99,199
"6699",2259,1921,1794,41,31,72
"6700",2340,1953,190,63,43,106
"6701",10,2039,250,78,94,172
"6702",1404,1216,270,34,51,85
"6703",2028,1838,397,68,38,106
"6704",2145,1744,412,55,44,99
"6705",2220,2108,423,45,38,83
"6706",2259,2151,511,38,41,79
"6707",2131,1835,570,82,40,122
"6708",2250,2026,670,101,91,192
"6709",22,2213,752,50,53,103
"6710",1845,1741,763,54,56,110
"6711",1807,1459,786,84,94,178
"6712",1247,1108,1476,40,33,73
"6713",1417,1255,1605,58,65,123
"6714",2136,1843,1889,106,58,164
"6715",1921,1544,1420,56,68,124
"6716",2230,1917,54,85,79,164
"6717",1058,810,944,48,70,118
"6718",2246,2001,8,227,251,478
"6719",1931,1627,2108,171,170,341
"6720",2318,2024,8,262,274,536
"6721",2335,2030,54,150,152,302
"6722",1818,1444,2108,98,67,165
"6723",1112,821,944,62,81,143
"6724",1716,1417,2108,36,40,76
"6725",939,642,1248,34,42,76
"6726",1549,1457,14,54,57,111
"6727",1252,1156,1317,47,51,98
"6728",1528,1444,2708,53,54,107
"6729",2255,2131,773,40,51,91
"6730",2033,1851,39,73,81,154
"6731",2311,2224,325,106,109,215
"6732",1534,1444,32,39,44,83
"6733",1713,1622,36,78,82,160
"6734",1908,1814,46,38,44,82
"6735",2017,1922,48,77,82,159
"6736",2057,2002,50,87,92,179
"6737",30,2331,55,130,126,256
"6738",2228,2133,313,98,98,196
"6739",1457,1407,1710,47,52,99
"6740",1836,1744,1919,41,44,85
"6741",1617,1525,2725,52,60,112
"6742",2147,2003,997,67,58,125
"6743",1639,1500,1420,39,40,79
"6744",1928,1813,630,68,73,141
"6745",10,2158,1767,80,88,168
"6746",1023,926,1558,73,76,149
"6747",1623,1401,827,208,201,409
"6748",2202,2047,117,37,42,79
"6749",17,2016,462,172,191,363
"6750",1516,1325,895,51,55,106
"6751",1940,1657,33,45,62,107
"6752",2144,2023,374,39,38,77
"6753",1437,1324,679,122,129,251
"6754",2050,2015,819,35,45,80
"6755",1605,1521,2708,90,91,181
"6756",2217,2128,325,52,53,105
"6757",1601,1509,32,66,69,135
"6758",2040,1945,52,40,45,85
"6759",1531,1442,300,51,57,108
"6760",132,2227,47,167,182,349
"6761",1529,1436,939,79,81,160
"6762",1700,1544,1675,55,54,109
"6763",37,2141,51,47,61,108
"6764",2234,2139,476,54,59,113
"6765",2158,2102,678,123,127,250
"6766",1343,1250,1576,33,40,73
"6767",2156,1748,37,31,43,74
"6768",1800,1719,31,105,109,214
"6769",9,2010,45,64,70,134
"6770",1935,1846,48,35,46,81
"6771",2130,2040,56,35,40,75
"6772",2227,2056,49,62,61,123
"6773",2347,2038,47,62,73,135
"6774",1901,1747,630,41,47,88
"6775",2103,1943,2299,98,88,186
"6776",2058,2004,819,43,34,77
"6777",110,2343,773,175,183,358
"6778",135,2356,39,375,386,761
"6779",331,2345,45,266,285,551
"6780",2340,1858,934,110,73,183
"6781",247,159,325,322,324,646
"6782",1340,1244,24,45,44,89
"6783",2045,1755,32,350,235,585
"6784",2015,1748,34,290,198,488
"6785",2040,1748,36,285,168,453
"6786",1947,1744,38,197,134,331
"6787",2111,1820,40,251,140,391
"6788",2031,1817,42,186,107,293
"6789",2144,1845,44,229,105,334
"6790",2255,1957,46,265,147,412
"6791",2201,1945,48,181,105,286
"6792",2243,2015,52,163,75,238
"6793",2307,2127,56,132,87,219
"6794",2310,2134,58,105,64,169
"6795",1841,1700,35,36,35,71
"6796",2331,2051,453,136,76,212
"6797",334,29,47,289,304,593
"6798",232,135,55,252,250,502
"6799",2139,2038,313,49,43,92
"6800",1452,1351,939,42,36,78
"6801",2236,2123,234,36,33,69
"6802",2149,2026,226,124,116,240
"6803",1726,1610,1675,81,80,161
"6804",1516,1329,534,146,139,285
"6805",2131,1938,997,51,33,84
"6806",1859,1736,630,39,36,75
"6807",346,48,51,236,248,484
"6808",44,2132,3938,134,132,266
"6809",25,2214,1767,95,104,199
"6810",1803,1708,1016,78,83,161
"6811",2328,2114,2994,98,99,197
"6812",2314,2141,117,109,96,205
"6813",1832,1629,1056,87,44,131
"6814",339,2334,37,374,389,763
"6815",2306,2226,720,191,196,387
"6816",2129,1951,787,64,51,115
"6817",1240,1125,795,95,105,200
"6818",2104,1957,2218,189,177,366
"6819",1956,1809,395,31,34,65
"6820",1339,1225,679,64,70,134
"6821",1255,1128,662,80,63,143
"6822",2159,2041,2299,154,146,300
"6823",1935,1855,104,110,115,225
"6824",2336,2256,819,201,206,407
"6825",1546,1440,2708,71,50,121
"6826",1358,1229,345,148,154,302
"6827",47,2323,773,152,163,315
"6828",2040,1900,39,80,90,170
"6829",1543,1359,113,48,54,102
"6830",149,2205,45,164,185,349
"6831",1813,1411,756,98,101,199
"6832",2306,1902,934,76,77,153
"6833",1754,1443,1411,79,88,167
"6834",2000,1904,27,285,279,564
"6835",2349,2304,41,294,299,593
"6836",2255,2206,325,90,91,181
"6837",1003,901,8,63,61,124
"6838",1518,1410,28,83,70,153
"6839",2034,1940,38,244,250,494
"6840",1941,1845,40,161,165,326
"6841",2043,1951,42,198,201,399
"6842",1953,1900,44,118,120,238
"6843",1937,1839,46,67,69,136
"6844",2021,1930,48,81,90,171
"6845",2307,2217,50,217,227,444
"6846",2127,2030,52,87,90,177
"6847",2,2312,56,187,192,379
"6848",25,2327,58,180,177,357
"6849",144,59,60,229,239,468
"6850",2015,1859,35,130,154,284
"6851",32,2316,453,197,221,418
"6852",109,2341,49,224,226,450
"6853",1525,1418,300,45,33,78
"6854",1954,1848,429,119,108,227
"6855",134,2221,47,169,176,345
"6856",1540,1236,15,70,76,146
"6857",20,2321,55,120,116,236
"6858",2229,2136,313,99,101,200
"6859",2122,2021,1919,207,201,408
"6860",1302,1155,7,117,120,237
"6861",2313,2200,234,73,70,143
"6862",1526,1416,1154,36,36,72
"6863",1722,1426,526,222,231,453
"6864",2143,2024,226,118,114,232
"6865",1401,1252,1104,51,57,108
"6866",2004,1850,1675,239,240,479
"6867",1448,1244,534,118,94,212
"6868",2359,2225,997,199,200,399
"6869",1633,1457,1420,33,37,70
"6870",1902,1743,630,42,43,85
"6871",237,2339,51,167,179,346
"6872",1713,1403,237,43,48,91
"6873",350,56,3938,320,336,656
"6874",1716,1500,565,31,40,71
"6875",2215,2007,659,105,122,227
"6876",2304,2055,1055,79,95,174
"6877",108,2303,1767,138,153,291
"6878",2302,2158,476,82,78,160
"6879",2346,2247,621,351,352,703
"6880",112,16,678,317,321,638
"6881",1210,1109,703,35,34,69
"6882",1840,1728,1016,115,103,218
"6883",2039,1934,1222,354,349,703
"6884",104,2259,2994,194,204,398
"6885",303,150,117,338,345,683
"6886",2238,2123,1056,333,338,671
"6887",2333,1938,37,128,153,281
"6888",34,2349,31,499,499,998
"6889",2133,2051,720,98,101,199
"6890",1505,1406,2170,60,46,106
"6891",2330,2206,787,185,186,371
"6892",1303,1126,11,78,36,114
"6893",2138,2051,155,368,376,744
"6894",110,29,410,215,224,439
"6895",1227,1104,575,152,124,276
"6896",2303,2219,2218,308,319,627
"6897",2327,2145,395,242,250,492
"6898",2200,1848,33,185,173,358
"6899",1534,1236,451,34,41,75
"6900",133,2237,1271,113,117,230
"6901",2307,2155,374,122,130,252
"6902",2107,1958,2299,102,103,205
"6903",2250,2205,325,85,90,175
"6904",1756,1702,36,121,122,243
"6905",1912,1813,40,132,133,265
"6906",1815,1722,42,50,52,102
"6907",2002,1910,50,32,40,72
"6908",2213,2056,453,58,81,139
"6909",1900,1805,1919,65,65,130
"6910",1752,1533,565,67,73,140
"6911",2222,2000,659,112,115,227
"6912",2323,2108,1767,33,38,71
"6913",2213,2122,476,33,42,75
"6914",2256,2140,117,91,95,186
"6915",17,2019,37,172,194,366
"6916",1646,1601,31,31,31,62
"6917",1202,1041,795,57,61,118
"6918",1844,1757,2218,49,57,106
"6919",1457,1309,372,32,39,71
"6920",14,2120,1271,34,40,74
"6921",2125,2017,1793,80,82,162
"6922",2025,1932,329,85,92,177
"6923",2126,2033,1706,211,213,424
"6924",2147,2056,1863,77,86,163
"6925",1923,1828,1889,53,58,111
"6926",2256,2207,2734,121,127,248
"6927",2019,1924,3452,84,84,168
"6928",2200,2049,3448,65,69,134
"6929",2118,1812,1441,48,57,105
"6930",2116,2021,1745,36,41,77
"6931",2051,1938,3151,51,58,109
"6932",2101,1941,2479,46,51,97
"6933",2136,2055,819,81,85,166
"6934",2350,1957,45,45,57,102
"6935",2342,1957,934,112,132,244
"6936",2226,2141,325,61,66,127
"6937",2122,2031,313,32,36,68
"6938",132,21,234,212,211,423
"6939",2310,2019,3938,40,59,99
"6940",2205,2040,117,40,35,75
"6941",2147,2105,635,112,115,227
"6942",6,2322,410,151,157,308
"6943",2211,2044,374,66,59,125
"6944",1227,1050,345,57,55,112
"6945",1427,1245,534,97,95,192
"6946",2044,1936,678,49,41,90
"6947",934,849,955,34,39,73
"6948",1238,1141,20,43,41,84
"6949",1504,1408,30,34,38,72
"6950",1556,1458,32,61,58,119
"6951",2321,2010,47,36,45,81
"6952",2118,1937,997,38,32,70
"6953",34,2141,51,44,61,105
"6954",1728,1622,1016,43,37,80
"6955",2036,1950,720,41,40,81
"6956",1149,1049,16,49,49,98
"6957",1629,1533,36,34,33,67
"6958",1806,1714,40,66,74,140
"6959",2044,1951,52,44,51,95
"6960",1843,1715,35,38,50,88
"6961",2151,2015,453,36,40,76
"6962",2353,2048,47,68,83,151
"6963",2139,2048,313,49,53,102
"6964",1646,1548,495,31,33,64
"6965",1640,1524,1675,35,34,69
"6966",1342,1200,534,52,50,102
"6967",1659,1520,1420,59,60,119
"6968",117,2305,1055,212,225,437
"6969",2209,2055,117,44,50,94
"6970",2238,1820,37,73,75,148
"6971",1700,1615,31,45,45,90
"6972",2201,2040,374,56,55,111
"6973",1956,1856,2299,31,41,72
"6974",2136,2050,819,81,80,161
"6975",6,2240,773,111,120,231
"6976",1958,1814,39,38,44,82
"6977",36,2049,45,91,109,200
"6978",2216,2129,325,51,54,105
"6979",1530,1437,32,35,37,72
"6980",1601,1508,34,36,38,74
"6981",1649,1556,36,54,56,110
"6982",1936,1846,48,36,46,82
"6983",2040,1952,50,70,82,152
"6984",2210,2115,56,75,75,150
"6985",2220,2112,453,65,97,162
"6986",2222,2057,49,57,62,119
"6987",1605,1518,300,85,93,178
"6988",2127,2030,313,37,35,72
"6989",1848,1751,1919,53,51,104
"6990",1946,1848,1675,221,238,459
"6991",1332,1208,534,42,58,100
"6992",2231,2109,997,111,124,235
"6993",2030,1917,630,130,137,267
"6994",24,2117,51,34,37,71
"6995",2346,2038,3938,76,78,154
"6996",2211,1958,659,101,113,214
"6997",2331,2120,1767,41,50,91
"6998",2233,2135,476,53,55,108
"6999",1851,1751,621,56,56,112
"7000",1725,1623,1016,40,38,78
"7001",2250,2053,2994,60,78,138
"7002",1805,1654,1056,60,69,129
"7003",1800,1715,31,105,105,210
"7004",2103,1955,787,38,55,93
"7005",2249,2159,410,74,74,148
"7006",1839,1745,2218,44,45,89
"7007",16,2115,1271,36,35,71
"7008",1825,1741,104,40,41,81
"7009",2321,2148,819,186,138,324
"7010",1056,1007,2025,71,67,138
"7011",1513,1429,2708,38,39,77
"7012",1,2224,773,106,104,210
"7013",2003,1819,39,43,49,92
"7014",311,2303,45,246,243,489
"7015",2231,1822,934,41,37,78
"7016",955,904,1,40,39,79
"7017",1627,1540,27,72,75,147
"7018",1950,1905,41,55,60,115
"7019",2241,2150,325,76,75,151
"7020",1311,1225,1867,31,35,66
"7021",1517,1407,30,47,37,84
"7022",1910,1727,38,160,117,277
"7023",2041,1747,40,221,107,328
"7024",2123,1829,42,238,119,357
"7025",2134,2020,44,219,200,419
"7026",2134,1833,46,184,63,247
"7027",2159,2021,48,179,141,320
"7028",7,2228,50,277,238,515
"7029",2212,2056,52,132,116,248
"7030",2318,2151,56,143,111,254
"7031",1839,1725,35,34,60,94
"7032",1254,1129,131,39,39,78
"7033",1547,1359,19,102,89,191
"7034",8,2244,49,163,169,332
"7035",2005,1900,429,130,120,250
"7036",251,2332,47,246,247,493
"7037",1533,1228,15,63,68,131
"7038",118,26,55,178,181,359
"7039",2238,2144,313,108,109,217
"7040",1604,1505,2725,39,40,79
"7041",2236,2125,234,36,35,71
"7042",1449,1151,526,69,76,145
"7043",2224,2054,226,159,144,303
"7044",1031,907,305,66,57,123
"7045",1650,1532,1104,220,217,437
"7046",1346,1215,534,56,65,121
"7047",2147,1956,997,67,51,118
"7048",1652,1518,1420,52,58,110
"7049",218,2310,51,148,150,298
"7050",1257,947,2202,117,122,239
"7051",13,2102,3938,103,102,205
"7052",2347,2120,1055,122,120,242
"7053",36,2225,1767,106,115,221
"7054",2241,2144,476,61,64,125
"7055",1915,1819,621,80,84,164
"7056",1408,1309,1576,58,59,117
"7057",1609,1356,301,194,196,390
"7058",2336,2124,117,131,79,210
"7059",1820,1700,1056,75,75,150
"7060",2250,1818,37,85,73,158
"7061",1452,1356,2170,47,36,83
"7062",1145,1028,795,40,48,88
"7063",2212,2118,410,37,33,70
"7064",1026,931,575,31,31,62
"7065",1849,1750,2218,54,50,104
"7066",2022,1824,395,57,49,106
"7067",1257,1102,1093,82,82,164
"7068",128,2226,1271,108,106,214
"7069",1415,1234,679,100,79,179
"7070",2047,1938,1793,42,43,85
"7071",1634,1439,1749,119,114,233
"7072",1147,735,1779,87,75,162
"7073",1937,1844,956,42,44,86
"7074",2115,1938,1924,55,53,108
"7075",2332,2021,18,42,41,83
"7076",1926,1722,1965,81,92,173
"7077",2105,1950,3151,65,70,135
"7078",1944,1531,2052,54,61,115
"7079",2019,1929,2235,54,49,103
"7080",2105,1939,2479,50,49,99
"7081",1618,1319,3280,48,54,102
"7082",1817,1738,104,32,38,70
"7083",1950,1905,41,55,60,115
"7084",1642,1551,36,47,51,98
"7085",1805,1712,42,40,42,82
"7086",2231,2132,50,181,182,363
"7087",2237,2126,56,102,86,188
"7088",2241,2132,58,76,62,138
"7089",2344,2238,60,109,98,207
"7090",2147,2015,453,32,40,72
"7091",1246,1128,2189,91,98,189
"7092",1929,1819,429,94,79,173
"7093",5,2317,55,105,112,217
"7094",10,2318,313,200,203,403
"7095",2214,1957,659,104,112,216
"7096",2336,2111,1767,46,41,87
"7097",1239,1150,11,54,60,114
"7098",1623,1537,155,53,62,115
"7099",2030,1825,395,65,50,115
"7100",2317,2156,773,62,76,138
"7101",1642,1507,113,107,122,229
"7102",1705,1618,27,110,113,223
"7103",1335,1206,16,155,126,281
"7104",1418,1227,20,143,87,230
"7105",1634,1541,36,39,41,80
"7106",2201,2110,58,36,40,76
"7107",1904,1703,35,59,38,97
"7108",1448,1320,19,43,50,93
"7109",2208,2040,49,43,45,88
"7110",2304,2208,55,44,43,87
"7111",2130,2040,313,40,45,85
"7112",2057,1942,226,72,72,144
"7113",1943,1826,630,83,86,169
"7114",44,2144,51,54,64,118
"7115",1833,1601,565,108,101,209
"7116",18,2210,1055,153,170,323
"7117",2240,2152,476,60,72,132
"7118",2205,2050,117,40,45,85
"7119",2043,2001,720,48,51,99
"7120",2219,2135,410,44,50,94
"7121",1457,1312,372,32,42,74
"7122",2010,1716,33,75,81,156
"7123",2148,2024,374,43,39,82
"7124",2016,1904,2299,51,49,100
"7125",1719,1412,1411,44,57,101
"7126",123,2342,52,323,282,605
"7127",54,2309,56,239,189,428
"7128",139,2352,58,254,202,456
"7129",110,2322,60,195,142,337
"7130",2319,2004,47,34,39,73
"7131",2357,2303,55,97,98,195
"7132",2130,1944,997,50,39,89
"7133",125,2222,3938,175,182,357
"7134",2340,2248,476,120,128,248
"7135",2234,2017,2994,44,42,86
"7136",2038,1946,720,43,36,79
"7137",1237,1125,662,62,60,122
"7138",1401,1313,500,131,128,259
"7139",1522,1427,2708,47,37,84
"7140",2346,2219,773,91,99,190
"7141",2001,1820,39,41,50,91
"7142",1821,1415,756,106,105,211
"7143",2357,1956,934,127,131,258
"7144",8,2322,325,163,167,330
"7145",1316,1222,20,81,82,163
"7146",1420,1323,24,85,83,168
"7147",1505,1400,28,70,60,130
"7148",1514,1422,30,44,52,96
"7149",1929,1816,36,214,196,410
"7150",1823,1709,42,58,39,97
"7151",2145,2032,46,195,182,377
"7152",2134,2021,48,154,141,295
"7153",38,2345,50,308,315,623
"7154",2336,2214,453,141,159,300
"7155",104,2334,49,219,219,438
"7156",1519,1420,300,39,35,74
"7157",2129,2037,429,214,217,431
"7158",2325,2017,47,40,52,92
"7159",2327,2235,55,67,70,137
"7160",1734,1640,495,79,85,164
"7161",2010,1908,1919,135,128,263
"7162",1319,1214,7,134,139,273
"7163",1652,1544,1154,122,124,246
"7164",2047,1931,226,62,61,123
"7165",1427,1312,1104,77,77,154
"7166",1933,1816,1675,208,206,414
"7167",1709,1540,1420,69,80,149
"7168",1955,1824,630,95,84,179
"7169",154,2255,51,124,135,259
"7170",235,2332,3938,245,252,497
"7171",1620,1411,129,200,216,416
"7172",1725,1459,565,40,39,79
"7173",12,2147,1055,147,147,294
"7174",1122,918,1094,87,108,195
"7175",46,2229,1767,116,119,235
"7176",2233,2143,476,53,63,116
"7177",2108,2014,678,73,79,152
"7178",144,25,117,259,260,519
"7179",1204,1048,494,74,73,147
"7180",454,101,37,449,476,925
"7181",1753,1657,155,143,142,285
"7182",222,137,410,287,292,579
"7183",1501,1309,372,36,39,75
"7184",2215,1922,33,200,207,407
"7185",17,2129,1271,37,49,86
"7186",1323,1208,679,48,53,101
"7187",1229,1124,662,54,59,113
"7188",2053,2009,819,38,39,77
"7189",1257,1112,583,32,37,69
"7190",2351,1953,45,46,53,99
"7191",2200,1758,756,325,328,653
"7192",2229,1820,934,39,35,74
"7193",2253,2208,325,88,93,181
"7194",1501,1403,30,31,33,64
"7195",1804,1712,36,129,132,261
"7196",1842,1750,42,77,80,157
"7197",1852,1758,44,57,58,115
"7198",1946,1854,48,46,54,100
"7199",2221,2134,58,56,64,120
"7200",1634,1500,19,149,150,299
"7201",1534,1445,300,54,60,114
"7202",1037,947,537,42,47,89
"7203",2321,2002,47,36,37,73
"7204",1532,1229,15,62,69,131
"7205",2320,2228,55,60,63,123
"7206",2121,2033,313,31,38,69
"7207",1854,1802,495,159,167,326
"7208",1512,1417,939,62,62,124
"7209",1152,1040,7,47,45,92
"7210",1655,1523,1154,125,103,228
"7211",1430,1133,526,50,58,108
"7212",1818,1706,1675,133,136,269
"7213",1155,1039,1615,90,99,189
"7214",41,2139,51,51,59,110
"7215",2311,2012,3938,41,52,93
"7216",1345,1113,129,45,38,83
"7217",2136,1910,659,66,65,131
"7218",2320,2056,1055,95,96,191
"7219",2339,2115,1767,49,45,94
"7220",2221,2126,476,41,46,87
"7221",1718,1620,1016,33,35,68
"7222",2230,2112,117,65,67,132
"7223",1746,1635,1056,41,50,91
"7224",2351,1930,37,146,145,291
"7225",2104,2028,720,69,78,147
"7226",2217,2131,410,42,46,88
"7227",1827,1735,2218,32,35,67
"7228",2329,2139,395,244,244,488
"7229",1219,1023,1093,44,43,87
"7230",20,2127,1271,40,47,87
"7231",2144,2024,374,39,39,78
"7232",1346,1225,679,71,70,141
"7233",2025,1946,104,160,166,326
"7234",2057,2016,819,42,46,88
"7235",1227,1100,345,57,65,122
"7236",2000,1816,39,40,46,86
"7237",42,2044,45,97,104,201
"7238",2335,1932,934,105,107,212
"7239",2211,2128,325,46,53,99
"7240",1359,1317,1867,79,87,166
"7241",1628,1533,34,63,63,126
"7242",1659,1604,36,64,64,128
"7243",2205,2116,58,40,46,86
"7244",29,2128,51,39,48,87
"7245",2332,2024,3938,62,64,126
"7246",1839,1612,565,114,112,226
"7247",2331,2115,1767,41,45,86
"7248",39,2341,476,179,181,360
"7249",1448,1246,301,113,126,239
"7250",1758,1635,1056,53,50,103
"7251",2233,1756,37,68,51,119
"7252",1713,1633,31,58,63,121
"7253",1721,1624,155,111,109,220
"7254",1649,1557,1392,49,57,106
"7255",1735,1648,40,35,48,83
"7256",2153,2059,313,63,64,127
"7257",2232,2121,1350,42,41,83
"7258",2353,2040,47,68,75,143
"7259",2304,2214,55,44,49,93
"7260",2242,2133,150,42,43,85
"7261",2208,2046,196,63,61,124
"7262",2342,2217,773,87,97,184
"7263",51,2102,934,181,197,378
"7264",1620,1447,19,135,137,272
"7265",1321,1003,5,36,38,74
"7266",1418,1252,534,88,102,190
"7267",2325,2019,3938,55,59,114
"7268",1725,1627,1016,40,42,82
"7269",11,2214,2994,141,159,300
"7270",2350,1947,37,145,162,307
"7271",1938,1635,33,43,40,83
"7272",1247,952,2004,44,52,96
"7273",2013,1719,2008,43,54,97
"7274",2003,1708,2008,33,43,76
"7275",2002,1712,2008,32,47,79
"7276",2030,1726,2008,45,46,91
"7277",1755,1451,2010,67,71,138
"7278",1720,1416,2010,47,51,98
"7279",1624,1521,2025,45,46,91
"7280",1616,1512,2025,37,37,74
"7281",1717,1529,2025,98,54,152
"7282",1654,1533,2025,75,58,133
"7283",5,2049,2027,78,89,167
"7284",2341,2003,2027,49,43,92
"7285",2330,1955,2027,38,35,73
"7286",2348,2020,2027,56,60,116
"7287",1252,910,2035,113,110,223
"7288",1155,810,2035,34,33,67
"7289",1147,808,2035,38,43,81
"7290",1432,1129,2036,82,79,161
"7291",1411,1111,2036,61,61,122
"7292",1512,1233,2041,72,58,130
"7293",2223,2051,2042,69,76,145
"7294",2150,2020,2042,36,45,81
"7295",2213,2034,2042,59,59,118
"7296",34,2254,2042,200,199,399
"7297",2230,2056,2042,76,81,157
"7298",2150,2013,2042,36,38,74
"7299",2223,2049,2042,49,54,103
"7300",2153,1839,2044,38,49,87
"7301",244,2331,2044,329,341,670
"7302",1613,1444,2048,71,59,130
"7303",233,2232,2050,233,217,450
"7304",1014,823,2056,32,38,70
"7305",1110,1014,2058,43,44,87
"7306",2043,1930,2062,61,55,116
"7307",2209,2106,2062,147,151,298
"7308",2023,1916,2062,41,41,82
"7309",2035,1926,2062,53,51,104
"7310",2223,2114,2062,161,159,320
"7311",1751,1645,2069,86,85,171
"7312",1707,1553,2069,42,33,75
"7313",1139,1003,2079,87,68,155
"7314",2339,2006,2094,45,41,86
"7315",1613,1458,2097,31,33,64
"7316",1628,1502,2097,46,37,83
"7317",1735,1621,2097,113,116,229
"7318",1437,1331,2101,100,92,192
"7319",1846,1432,2105,143,97,240
"7320",2117,1839,2122,165,169,334
"7321",1922,1647,2122,35,32,67
"7322",1625,1524,2128,36,39,75
"7323",16,2320,2131,126,120,246
"7324",2355,2303,2131,100,103,203
"7325",2330,2229,2131,75,69,144
"7326",928,814,2132,35,39,74
"7327",2134,1932,2147,126,117,243
"7328",2039,1846,2147,71,71,142
"7329",2038,1851,2147,70,76,146
"7330",2220,2038,2168,98,78,176
"7331",56,2115,2171,119,130,249
"7332",3,2017,2171,71,77,148
"7333",35,2025,2171,103,85,188
"7334",136,2145,2171,164,165,329
"7335",1716,1542,2174,166,157,323
"7336",1047,932,2176,40,32,72
"7337",1434,1334,2189,46,44,90
"7338",1430,1325,2189,42,35,77
"7339",1704,1528,2196,84,63,147
"7340",1828,1501,2198,54,46,100
"7341",1843,1512,2198,69,57,126
"7342",1835,1510,2198,61,55,116
"7343",1415,1255,2200,78,75,153
"7344",1205,1011,2210,47,46,93
"7345",1927,1824,2212,39,34,73
"7346",1938,1835,2212,50,45,95
"7347",1938,1839,2212,50,49,99
"7348",2016,1910,2212,88,80,168
"7349",1520,1356,2213,37,36,73
"7350",1543,1414,2213,60,54,114
"7351",1504,1359,2223,77,69,146
"7352",1338,1002,2240,170,167,337
"7353",1103,817,2246,39,51,90
"7354",1121,810,2246,57,44,101
"7355",2328,2028,2253,53,63,116
"7356",110,2152,2253,155,147,302
"7357",2329,2032,2253,59,67,126
"7358",2342,2024,2253,67,59,126
"7359",2258,2207,2261,48,47,95
"7360",2318,2215,2261,68,55,123
"7361",2352,2303,2261,102,103,205
"7362",1752,1437,2264,63,57,120
"7363",1738,1420,2264,49,40,89
"7364",1818,1506,2264,89,86,175
"7365",1714,1408,2264,40,38,78
"7366",1535,1230,2272,33,40,73
"7367",1538,1229,2272,36,39,75
"7368",1611,1315,2272,45,58,103
"7369",2126,1738,2276,74,43,117
"7370",2221,1810,2276,119,65,184
"7371",2115,1802,2276,63,67,130
"7372",2110,1902,2278,217,212,429
"7373",1830,1601,2278,57,31,88
"7374",1827,1614,2278,54,44,98
"7375",1935,1706,2278,122,96,218
"7376",2215,2045,2280,52,50,102
"7377",2154,2032,2280,31,37,68
"7378",2215,2055,2280,52,60,112
"7379",2203,2038,2280,40,43,83
"7380",2324,2202,2280,121,127,248
"7381",2250,2129,2280,87,94,181
"7382",2240,2022,2283,40,32,72
"7383",2250,2021,2283,50,31,81
"7384",7,2156,2283,127,126,253
"7385",2332,2119,2283,92,89,181
"7386",2252,2035,2283,52,45,97
"7387",2255,2055,2283,55,65,120
"7388",2234,2026,2283,34,36,70
"7389",2244,2022,2283,44,32,76
"7390",50,2127,2288,93,82,175
"7391",2349,2037,2288,47,52,99
"7392",31,2113,2288,89,88,177
"7393",304,2358,2288,242,253,495
"7394",36,2054,2288,89,64,153
"7395",2349,2037,2288,47,52,99
"7396",2339,2017,2288,37,32,69
"7397",203,2236,2288,156,146,302
"7398",1412,1110,2295,49,50,99
"7399",2006,1626,2298,66,40,106
"7400",1925,1611,2298,36,36,72
"7401",1138,941,2302,38,31,69
"7402",1456,1350,2304,49,55,104
"7403",1656,1553,2308,36,38,74
"7404",1745,1629,2308,87,76,163
"7405",1753,1649,2308,93,94,187
"7406",1732,1604,2308,72,49,121
"7407",1834,1456,2317,57,41,98
"7408",1921,1542,2317,104,87,191
"7409",1843,1522,2329,104,107,211
"7410",1821,1520,2334,59,60,119
"7411",1800,1451,2334,38,31,69
"7412",1908,1516,2334,106,56,162
"7413",1659,1525,2336,44,43,87
"7414",1706,1533,2336,51,51,102
"7415",1718,1535,2336,63,53,116
"7416",1443,1114,2344,46,54,100
"7417",1836,1659,2346,49,54,103
"7418",20,2337,2349,128,137,265
"7419",29,2336,2349,137,136,273
"7420",138,53,2349,206,213,419
"7421",48,2353,2349,156,153,309
"7422",2310,2223,2349,58,63,121
"7423",2258,2157,2349,41,32,73
"7424",2338,2219,2357,83,64,147
"7425",46,2341,2357,146,146,292
"7426",1,2257,2357,101,102,203
"7427",2026,1846,2376,43,41,84
"7428",2237,1923,2376,174,78,252
"7429",2139,2005,2376,116,120,236
"7430",2323,2155,2376,225,230,455
"7431",1742,1438,2380,48,48,96
"7432",1749,1430,2380,59,40,99
"7433",1734,1438,2380,40,48,88
"7434",1445,1125,2386,38,40,78
"7435",1816,1457,2389,97,87,184
"7436",1952,1547,2397,107,60,167
"7437",1838,1520,2397,35,35,70
"7438",1844,1524,2397,41,39,80
"7439",2202,2020,2400,130,128,258
"7440",2157,1956,2400,127,106,233
"7441",1228,1041,2402,41,31,72
"7442",1244,1116,2402,62,66,128
"7443",1759,1505,2405,41,50,91
"7444",1754,1451,2405,36,36,72
"7445",1755,1449,2405,45,39,84
"7446",2349,2246,2418,175,166,341
"7447",2145,2059,2418,51,59,110
"7448",1957,1848,2425,45,43,88
"7449",2222,2115,2425,190,190,380
"7450",1943,1839,2425,31,34,65
"7451",1639,1514,2427,52,54,106
"7452",1729,1527,2427,102,67,169
"7453",1655,1538,2430,32,33,65
"7454",1356,1218,2433,68,53,121
"7455",1248,1058,2434,64,38,102
"7456",1053,920,2441,116,105,221
"7457",1724,1633,2442,54,58,112
"7458",1846,1742,2442,136,127,263
"7459",1729,1615,2442,59,40,99
"7460",25,2340,2450,36,40,76
"7461",56,2359,2450,67,59,126
"7462",1108,1005,2453,44,50,94
"7463",2235,2101,2456,121,101,222
"7464",144,2400,2456,310,280,590
"7465",2319,2151,2456,165,151,316
"7466",2236,2030,2456,122,70,192
"7467",15,2315,2456,221,235,456
"7468",2235,2135,2456,121,135,256
"7469",1909,1749,2465,77,79,156
"7470",927,821,2469,40,31,71
"7471",1114,837,2470,41,47,88
"7472",1845,1533,2472,43,33,76
"7473",1831,1529,2472,39,39,78
"7474",2009,1631,2472,137,101,238
"7475",1843,1650,2474,76,75,151
"7476",1821,1635,2474,54,60,114
"7477",1843,1633,2474,76,58,134
"7478",1834,1638,2474,67,63,130
"7479",1811,1441,2478,39,31,70
"7480",1717,1502,2479,57,47,104
"7481",2158,2057,2481,96,92,188
"7482",2118,2021,2481,56,56,112
"7483",2151,2057,2481,89,92,181
"7484",2231,2135,2481,129,130,259
"7485",2233,1830,2488,160,115,275
"7486",2131,1754,2488,98,79,177
"7487",2203,1839,2488,130,124,254
"7488",18,2056,2492,54,61,115
"7489",38,2057,2492,79,67,146
"7490",2356,2031,2492,37,41,78
"7491",2031,1640,2492,69,55,124
"7492",2036,1637,2492,74,52,126
"7493",44,2304,2493,117,114,231
"7494",1809,1637,2497,31,37,68
"7495",1526,1413,2499,71,58,129
"7496",1522,1420,2499,67,65,132
"7497",1252,1159,2501,40,34,74
"7498",2341,2223,2515,79,63,142
"7499",2352,2251,2515,90,91,181
"7500",1833,1437,2532,113,97,210
"7501",1902,1804,2562,35,34,69
"7502",1912,1809,2562,45,39,84
"7503",2037,1930,2562,130,120,250
"7504",1909,1807,2562,42,37,79
"7505",1454,1056,2568,41,31,72
"7506",1739,1427,2572,42,47,89
"7507",1745,1425,2572,48,45,93
"7508",1016,820,2573,64,60,124
"7509",1652,1559,2581,83,79,162
"7510",1611,1515,2581,57,55,112
"7511",1137,824,2586,40,44,84
"7512",1559,1501,2591,31,31,62
"7513",1626,1521,2591,58,51,109
"7514",1609,1412,2593,61,67,128
"7515",1622,1413,2593,74,68,142
"7516",2400,2052,2597,75,77,152
"7517",41,2126,2597,116,111,227
"7518",1855,1527,2598,98,72,170
"7519",1809,1518,2598,52,63,115
"7520",2232,1920,2598,315,305,620
"7521",1754,1529,2598,89,74,163
"7522",1554,1223,2599,105,93,198
"7523",1545,1527,2601,31,42,73
"7524",1057,957,2605,57,57,114
"7525",934,800,2606,39,35,74
"7526",918,746,2606,33,31,64
"7527",1456,1144,2622,54,54,108
"7528",1443,1131,2622,41,41,82
"7529",1701,1558,2625,38,35,73
"7530",1805,1500,2629,103,105,208
"7531",1701,1355,2629,39,40,79
"7532",1731,1419,2629,69,64,133
"7533",1612,1518,2631,40,38,78
"7534",1645,1543,2631,78,68,146
"7535",1150,940,2632,40,35,75
"7536",1219,1010,2632,69,65,134
"7537",1143,945,2632,38,40,78
"7538",2331,2029,2651,119,49,168
"7539",2234,2045,2651,82,85,167
"7540",2245,2057,2651,93,97,190
"7541",2211,2021,2651,59,61,120
"7542",2241,2048,2651,104,103,207
"7543",1500,1147,2652,66,67,133
"7544",1448,1134,2652,39,44,83
"7545",2257,2158,2654,35,43,78
"7546",1915,1808,2658,41,38,79
"7547",2323,2116,2675,289,226,515
"7548",1943,1838,2675,69,68,137
"7549",921,754,2687,47,39,86
"7550",2252,2159,2692,45,44,89
"7551",2238,2150,2692,31,35,66
"7552",8,2322,2692,121,127,248
"7553",2358,2308,2692,111,113,224
"7554",2022,1745,2695,160,100,260
"7555",1755,1452,2700,38,37,75
"7556",2310,1959,2700,155,144,299
"7557",1735,1522,2700,70,67,137
"7558",1721,1450,2700,56,35,91
"7559",1721,1506,2700,56,51,107
"7560",1819,1709,2705,37,39,76
"7561",1830,1718,2705,48,48,96
"7562",2206,1952,2712,59,52,111
"7563",120,2323,2712,253,263,516
"7564",2317,2051,2712,130,111,241
"7565",2153,1948,2712,51,48,99
"7566",2147,1933,2712,40,33,73
"7567",2254,2049,2712,107,109,216
"7568",2300,2055,2712,113,115,228
"7569",2338,2132,2712,151,152,303
"7570",1723,1415,2715,36,40,76
"7571",1634,1513,2719,49,48,97
"7572",2019,1724,2728,50,52,102
"7573",2046,1739,2728,64,54,118
"7574",2126,1806,2728,104,81,185
"7575",2023,1925,2731,41,35,76
"7576",2153,2047,2731,131,117,248
"7577",1430,1130,2736,80,80,160
"7578",1447,1132,2736,97,82,179
"7579",1351,1045,2736,41,35,76
"7580",1943,1827,2748,80,82,162
"7581",1937,1811,2748,69,61,130
"7582",2044,1847,2748,154,115,269
"7583",1245,1108,2750,53,58,111
"7584",1810,1717,2755,121,117,238
"7585",1757,1614,2755,108,54,162
"7586",2116,1929,2759,79,69,148
"7587",2027,1856,2759,60,66,126
"7588",1829,1508,2763,95,98,193
"7589",1557,1459,2769,83,72,155
"7590",1514,1417,2769,42,32,74
"7591",1539,1451,2769,67,66,133
"7592",2219,2104,2776,114,99,213
"7593",2152,2056,2776,87,91,178
"7594",1705,1533,2778,53,38,91
"7595",1655,1531,2778,43,36,79
"7596",2046,1711,2781,34,41,75
"7597",2332,2034,2782,77,79,156
"7598",2344,2043,2782,54,53,107
"7599",5,2053,2782,110,98,208
"7600",2305,2000,2782,50,45,95
"7601",2331,2038,2782,76,83,159
"7602",2335,2038,2782,80,83,163
"7603",2335,2031,2782,80,76,156
"7604",28,2304,2789,111,109,220
"7605",1919,1819,2790,50,44,94
"7606",1609,1409,2794,44,34,78
"7607",1728,1536,2796,49,49,98
"7608",2147,2022,2800,49,52,101
"7609",2210,2043,2800,72,73,145
"7610",2142,2018,2800,44,48,92
"7611",2257,2009,2800,119,39,158
"7612",2153,2027,2800,55,57,112
"7613",2342,2001,2801,40,46,86
"7614",2326,1902,2801,224,187,411
"7615",1829,1442,2801,97,92,189
"7616",2034,1647,2801,52,52,104
"7617",2045,1642,2801,63,47,110
"7618",312,152,2803,317,287,604
"7619",2239,2139,2803,44,34,78
"7620",2326,2241,2803,91,96,187
"7621",47,2358,2803,172,173,345
"7622",2349,2224,2803,114,79,193
"7623",2248,2201,2803,53,56,109
"7624",2129,2007,2804,42,47,89
"7625",2155,2031,2804,73,76,149
"7626",2240,2116,2804,118,121,239
"7627",2134,2007,2804,52,52,104
"7628",2135,2009,2804,53,54,107
"7629",2217,2026,2804,95,71,166
"7630",2207,2045,2804,85,90,175
"7631",1733,1637,2809,69,67,136
"7632",1715,1608,2809,56,38,94
"7633",1723,1627,2809,59,57,116
"7634",1736,1641,2809,72,71,143
"7635",1509,1350,2811,64,60,124
"7636",1419,1315,2817,107,105,212
"7637",2321,2021,2822,38,46,84
"7638",120,2210,2822,157,155,312
"7639",2343,2038,2822,60,63,123
"7640",2354,2037,2822,56,47,103
"7641",1508,1326,2824,38,31,69
"7642",1536,1404,2824,66,69,135
"7643",1351,1232,2826,89,70,159
"7644",1221,1059,2833,53,44,97
"7645",1838,1721,2834,77,72,149
"7646",1910,1732,2840,65,54,119
"7647",1904,1723,2840,59,45,104
"7648",2038,1834,2840,146,109,255
"7649",1957,1828,2840,112,110,222
"7650",1843,1720,2840,38,42,80
"7651",1928,1756,2840,83,78,161
"7652",1813,1423,2841,94,63,157
"7653",1908,1528,2841,149,128,277
"7654",1512,1338,2844,49,48,97
"7655",1543,1410,2844,75,75,150
"7656",1519,1328,2881,46,43,89
"7657",1554,1410,2881,81,85,166
"7658",1525,1338,2881,52,53,105
"7659",1557,1409,2881,84,84,168
"7660",2143,1945,2882,143,135,278
"7661",23,2218,2882,303,288,591
"7662",937,833,2891,70,78,148
"7663",944,836,2891,77,81,158
"7664",1949,1856,2902,62,61,123
"7665",2137,2045,2902,170,170,340
"7666",1928,1842,2902,41,47,88
"7667",2220,2114,2907,122,114,236
"7668",2159,2103,2907,91,93,184
"7669",2110,2015,2907,42,45,87
"7670",2121,2035,2907,53,65,118
"7671",1906,1726,2920,76,56,132
"7672",1905,1739,2920,70,64,134
"7673",1858,1738,2920,40,40,80
"7674",2107,2008,2921,49,53,102
"7675",1224,1055,2928,57,45,102
"7676",1211,1046,2928,34,31,65
"7677",1709,1616,2936,34,33,67
"7678",2239,2049,2938,55,39,94
"7679",2226,2047,2938,37,32,69
"7680",2344,2205,2938,115,110,225
"7681",2249,2106,2938,60,51,111
"7682",2241,2102,2938,52,47,99
"7683",2253,2107,2938,64,52,116
"7684",2307,2117,2938,78,62,140
"7685",2236,2055,2938,47,40,87
"7686",1024,922,2939,39,37,76
"7687",1827,1656,2944,34,36,70
"7688",1701,1527,2945,61,62,123
"7689",1656,1516,2945,56,51,107
"7690",1631,1458,2945,31,33,64
"7691",1703,1518,2945,63,53,116
"7692",1928,1700,2948,43,45,88
"7693",16,2135,2948,331,320,651
"7694",1905,1645,2948,45,55,100
"7695",2205,2043,2954,86,83,169
"7696",2155,2042,2954,76,82,158
"7697",1447,1130,2960,60,60,120
"7698",1815,1649,2964,241,219,460
"7699",1118,927,2967,51,32,83
"7700",2155,1948,2974,128,123,251
"7701",2033,1836,2974,46,51,97
"7702",2024,1816,2974,37,31,68
"7703",2206,2014,2974,139,149,288
"7704",2342,2141,2974,235,236,471
"7705",2048,1842,2974,61,57,118
"7706",6,2205,2976,64,55,119
"7707",57,2313,2976,115,123,238
"7708",2336,2146,2976,34,36,70
"7709",1754,1448,2980,94,88,182
"7710",1740,1425,2980,80,65,145
"7711",1118,1045,2988,83,80,163
"7712",1304,1132,2996,69,46,115
"7713",1315,1200,2996,75,74,149
"7714",1550,1421,2998,92,91,183
"7715",1539,1416,2998,81,86,167
"7716",1641,1410,3004,61,60,121
"7717",1618,1346,3004,38,36,74
"7718",1917,1806,3005,48,31,79
"7719",221,55,3016,299,310,609
"7720",2232,2101,3016,70,76,146
"7721",2243,2111,3016,81,86,167
"7722",55,2300,3016,213,195,408
"7723",2220,2046,3016,73,76,149
"7724",2147,2041,3022,62,71,133
"7725",9,2231,3022,170,141,311
"7726",2131,2029,3027,128,129,257
"7727",2020,1910,3027,62,55,117
"7728",1142,817,3032,42,35,77
"7729",1855,1711,3033,182,171,353
"7730",1657,1512,3033,64,52,116
"7731",1917,1651,3033,204,151,355
"7732",143,2217,3036,154,137,291
"7733",2358,2039,3036,49,39,88
"7734",2349,2041,3036,40,41,81
"7735",45,2113,3036,96,73,169
"7736",18,2110,3036,69,70,139
"7737",2357,2049,3036,48,49,97
"7738",2235,2040,3038,62,60,122
"7739",2259,2105,3038,81,80,161
"7740",2230,2038,3038,47,48,95
"7741",2226,2041,3038,48,56,104
"7742",2214,2029,3038,36,44,80
"7743",2342,2216,3043,69,56,125
"7744",2347,2024,3050,89,69,158
"7745",2348,2053,3050,80,88,168
"7746",2318,2019,3050,50,54,104
"7747",13,2111,3050,100,101,201
"7748",2339,2018,3050,71,53,124
"7749",2307,2014,3050,39,49,88
"7750",2317,2011,3050,49,46,95
"7751",2328,2028,3050,60,63,123
"7752",2318,2016,3050,53,51,104
"7753",935,827,3059,47,57,104
"7754",2120,2006,3062,76,76,152
"7755",1816,1436,3078,40,42,82
"7756",1913,1521,3078,97,87,184
"7757",1842,1456,3078,66,62,128
"7758",1905,1513,3078,89,79,168
"7759",1905,1511,3078,73,61,134
"7760",1123,856,3083,65,71,136
"7761",1456,1300,3092,43,40,83
"7762",1623,1424,3092,130,124,254
"7763",1144,823,3096,45,53,98
"7764",1217,829,3096,83,59,142
"7765",2051,1708,3098,93,87,180
"7766",2005,1614,3098,47,33,80
"7767",2037,1645,3098,79,64,143
"7768",2115,1745,3098,118,120,238
"7769",2001,1619,3098,43,38,81
"7770",2033,1909,3101,46,44,90
"7771",2226,2052,3101,154,142,296
"7772",2056,1916,3101,69,51,120
"7773",2023,1902,3101,36,37,73
"7774",1247,1124,3119,69,59,128
"7775",2143,2013,3127,106,103,209
"7776",2158,1925,3127,121,55,176
"7777",2233,2106,3127,156,156,312
"7778",2108,1942,3127,71,72,143
"7779",2050,1917,3127,53,47,100
"7780",2144,2021,3127,107,111,218
"7781",2340,2037,3137,37,42,79
"7782",59,2147,3137,126,122,248
"7783",2348,2047,3137,55,62,117
"7784",2348,2039,3137,55,54,109
"7785",2333,2032,3137,40,47,87
"7786",28,2130,3137,90,100,190
"7787",1818,1617,3150,46,37,83
"7788",1400,1226,3152,62,61,123
"7789",2030,1916,3155,63,56,119
"7790",2101,1940,3155,94,80,174
"7791",2028,1858,3155,56,33,89
"7792",2104,1948,3155,97,88,185
"7793",1648,1500,1136,31,35,66
"7794",1716,1524,1136,59,59,118
"7795",1708,1511,1136,51,46,97
"7796",1419,1232,1145,87,92,179
"7797",1637,1453,1147,72,78,150
"7798",2130,1759,1149,98,64,162
"7799",2028,1726,1149,39,34,73
"7800",2038,1744,1149,59,62,121
"7801",2322,2033,1149,210,218,428
"7802",2317,1958,1149,205,183,388
"7803",1041,946,1151,49,46,95
"7804",1032,933,1151,40,33,73
"7805",40,2346,1153,57,46,103
"7806",19,2337,1153,36,37,73
"7807",2104,1841,1153,46,31,77
"7808",2128,1918,1153,70,68,138
"7809",2051,1843,1153,33,33,66
"7810",1831,1420,1154,81,55,136
"7811",1901,1524,1154,111,119,230
"7812",1822,1419,1154,72,54,126
"7813",1847,1420,1154,97,55,152
"7814",1101,938,1180,41,33,74
"7815",917,831,1184,70,71,141
"7816",1939,1840,1185,41,35,76
"7817",2048,1957,1185,110,112,222
"7818",2317,2156,1185,259,231,490
"7819",2121,2027,1185,143,142,285
"7820",1712,1332,1186,45,37,82
"7821",1636,1347,1187,36,47,83
"7822",1456,1255,1187,44,50,94
"7823",1453,1249,1187,51,52,103
"7824",1846,1744,1188,101,84,185
"7825",1803,1711,1188,49,42,91
"7826",1640,1346,1190,32,41,73
"7827",1430,1214,1191,53,44,97
"7828",2127,2029,1193,203,174,377
"7829",2035,1924,1193,151,109,260
"7830",1852,1811,1193,53,41,94
"7831",1951,1809,1193,112,39,151
"7832",1904,1831,1193,65,61,126
"7833",1831,1804,1193,32,34,66
"7834",1311,1205,1197,54,40,94
"7835",2350,2303,1128,160,133,293
"7836",2235,2147,1126,85,57,142
"7837",1736,1411,1118,84,71,155
"7838",2322,2136,1126,37,41,78
"7839",211,40,1126,206,225,431
"7840",1706,1532,1130,59,42,101
"7841",1715,1534,1130,68,44,112
"7842",1656,1535,1130,49,45,94
"7843",1708,1551,1130,61,61,122
"7844",1756,1635,1130,109,105,214
"7845",2020,1821,1130,253,211,464
"7846",1326,1134,1142,181,149,330
"7847",207,2250,1117,225,225,450
"7848",2307,1945,1117,45,40,85
"7849",128,2216,1117,186,191,377
"7850",1242,1111,1171,72,91,163
"7851",2324,2128,1172,44,38,82
"7852",2346,2202,1172,101,72,173
"7853",2324,2210,1172,79,80,159
"7854",23,2305,1172,138,135,273
"7855",2329,2201,1172,84,71,155
"7856",2255,2130,1172,50,40,90
"7857",1832,1540,1176,129,114,243
"7858",1723,1435,1176,60,49,109
"7859",1712,1427,1176,49,41,90
"7860",1156,759,1177,54,39,93
"7861",2300,1942,1179,95,47,142
"7862",2307,2208,1138,54,53,107
"7863",121,2336,1138,188,141,329
"7864",2139,2019,1155,57,59,116
"7865",2157,2009,1155,65,39,104
"7866",2210,2047,1155,78,77,155
"7867",2138,2026,1155,46,56,102
"7868",2208,2035,1155,76,65,141
"7869",2156,2034,1155,64,64,128
"7870",2125,2016,1155,33,46,79
"7871",1820,1722,1156,80,67,147
"7872",1749,1700,1156,49,45,94
"7873",2223,1931,1159,58,36,94
"7874",2317,2043,1159,112,108,220
"7875",1445,1104,1167,38,39,77
"7876",2309,2159,1138,56,44,100
"7877",2310,2211,1138,57,56,113
"7878",22,2308,1112,140,128,268
"7879",2331,1942,1113,34,42,76
"7880",315,2318,1113,258,258,516
"7881",310,2311,1113,253,251,504
"7882",33,2022,1113,96,82,178
"7883",2354,2025,1117,77,65,142
"7884",2326,2025,1117,64,80,144
"7885",1715,1346,1107,68,63,131
"7886",2222,2139,1108,72,49,121
"7887",1,2315,1108,171,145,316
"7888",2220,2128,1108,70,38,108
"7889",1925,1825,1102,53,55,108
"7890",2313,2155,1102,276,265,541
"7891",2142,2023,1123,170,163,333
"7892",1841,1519,1124,82,84,166
"7893",1859,1538,1124,100,103,203
"7894",1821,1500,1124,62,65,127
"7895",2340,2006,1125,38,41,79
"7896",1957,1622,1118,225,202,427
"7897",26,2131,4455,223,181,404
"7898",1657,1509,4489,39,59,98
"7899",1639,1341,5800,36,41,77
"7900",1236,930,5801,38,40,78
"7901",1304,1004,5801,71,74,145
"7902",1706,1341,5803,203,186,389
"7903",1430,1113,5803,47,38,85
"7904",1906,1531,5803,234,208,442
"7905",1531,1153,5803,108,78,186
"7906",2335,2213,5805,48,48,96
"7907",2325,2204,5805,38,39,77
"7908",1636,1503,5807,46,33,79
"7909",1659,1509,5807,69,39,108
"7910",1736,1604,5807,106,94,200
"7911",1910,1737,5807,200,187,387
"7912",1639,1521,5807,49,51,100
"7913",1842,1643,5810,68,63,131
"7914",1905,1707,5814,88,87,175
"7915",1846,1617,5814,69,37,106
"7916",1850,1654,5814,73,74,147
"7917",1858,1636,5814,81,56,137
"7918",2100,1927,5816,73,52,125
"7919",123,2156,5817,124,111,235
"7920",1937,1623,5818,42,37,79
"7921",1253,945,5828,35,35,70
"7922",1251,954,5828,33,39,72
"7923",1531,1229,5828,193,194,387
"7924",28,2129,5834,46,39,85
"7925",238,2337,5834,176,167,343
"7926",113,2202,5834,91,72,163
"7927",48,2203,5834,66,73,139
"7928",2232,1939,5835,92,99,191
"7929",2153,1831,5835,53,31,84
"7930",2228,1906,5835,88,66,154
"7931",2018,1724,5835,56,54,110
"7932",2157,1855,5835,57,55,112
"7933",2142,1839,5835,42,39,81
"7934",11,2115,5835,191,195,386
"7935",2214,2018,5838,127,93,220
"7936",1357,1022,5840,68,52,120
"7937",1338,1009,5840,49,39,88
"7938",1417,1057,5840,88,87,175
"7939",2102,1938,5842,92,83,175
"7940",2150,2022,5842,140,127,267
"7941",2113,1959,5842,103,104,207
"7942",2007,1846,5842,37,31,68
"7943",2223,2102,5842,173,167,340
"7944",2212,2003,5842,162,108,270
"7945",2109,1919,5842,99,64,163
"7946",2344,2207,5842,254,232,486
"7947",2014,1859,5842,44,44,88
"7948",29,2344,5845,46,44,90
"7949",1145,907,6547,188,187,375
"7950",946,717,6547,69,77,146
"7951",841,715,6698,77,75,152
"7952",2121,1849,230,81,79,160
"7953",2128,1831,230,88,61,149
"7954",1010,802,368,33,36,69
"7955",1901,1506,552,51,52,103
"7956",1018,827,567,33,53,86
"7957",1110,903,567,93,97,190
"7958",1539,1416,735,87,89,176
"7959",1513,1358,735,71,81,152
"7960",1447,1312,776,45,37,82
"7961",1521,1359,801,66,70,136
"7962",1624,1408,855,309,310,619
"7963",1201,949,855,46,51,97
"7964",1235,1020,855,80,82,162
"7965",1429,1046,1015,50,32,82
"7966",1239,907,1696,122,117,239
"7967",2220,1847,959,80,72,152
"7968",1128,751,1696,51,41,92
"7969",1500,1116,1170,80,61,141
"7970",2308,1937,1978,250,247,497
"7971",728,644,270,41,44,85
"7972",1938,1845,528,38,45,83
"7973",2243,1921,959,103,106,209
"7974",2340,2024,959,160,169,329
"7975",2056,1704,1978,118,94,212
"7976",1934,1611,1978,36,41,77
"7977",1528,1152,1170,108,97,205
"7978",1828,1737,269,159,157,316
"7979",936,556,996,50,36,86
"7980",2219,1828,959,79,53,132
"7981",2231,1825,959,91,50,141
"7982",1131,751,1696,54,41,95
"7983",2248,2118,773,33,38,71
"7984",1540,1355,113,45,50,95
"7985",2353,2011,45,48,71,119
"7986",1628,1539,27,73,74,147
"7987",2159,2106,325,34,31,65
"7988",1319,1231,1867,39,41,80
"7989",1556,1505,34,31,35,66
"7990",1711,1618,36,76,78,154
"7991",2028,1940,48,88,100,188
"7992",109,2350,453,234,255,489
"7993",1516,1351,19,71,81,152
"7994",2227,2059,49,62,64,126
"7995",56,2146,47,131,141,272
"7996",2310,2216,55,50,51,101
"7997",2150,2056,313,60,61,121
"7998",1529,1435,1710,79,80,159
"7999",1920,1826,1919,85,86,171
"8000",1607,1505,2725,42,40,82
"8001",2233,2129,234,33,39,72
"8002",2133,1935,1675,328,285,613
"8003",1712,1513,1420,72,53,125
"8004",1323,1153,2449,33,43,76
"8005",1910,1751,630,50,51,101
"8006",2307,2005,3938,37,45,82
"8007",2258,2031,1055,73,71,144
"8008",2343,2119,1767,53,49,102
"8009",1904,1811,621,69,76,145
"8010",2315,2202,117,110,117,227
"8011",1355,1240,784,95,95,190
"8012",2144,1939,787,79,39,118
"8013",1605,1511,155,35,36,71
"8014",13,2119,1271,33,39,72
"8015",2158,2019,374,53,34,87
"8016",1224,1110,662,49,45,94
"8017",1819,1732,104,34,32,66
"8018",142,10,773,207,210,417
"8019",2008,1828,39,48,58,106
"8020",948,900,1,33,35,68
"8021",2322,2228,325,117,113,230
"8022",1616,1527,34,51,57,108
"8023",1924,1836,44,89,96,185
"8024",1952,1857,48,52,57,109
"8025",1306,1152,131,51,62,113
"8026",1443,1308,19,38,38,76
"8027",1533,1435,300,53,50,103
"8028",1514,1210,15,44,50,94
"8029",1050,944,3,50,44,94
"8030",1151,1045,7,46,50,96
"8031",24,2318,234,144,148,292
"8032",1000,841,305,35,31,66
"8033",2226,2056,630,246,236,482
"8034",1137,824,2202,37,39,76
"8035",2106,1858,659,36,53,89
"8036",2306,2100,1055,81,100,181
"8037",1245,1147,703,70,72,142
"8038",1353,1256,1576,43,46,89
"8039",2224,2058,117,59,53,112
"8040",1000,848,171,60,63,123
"8041",245,2254,37,320,349,669
"8042",2045,1954,720,50,44,94
"8043",1220,1127,11,35,37,72
"8044",2229,2143,410,54,58,112
"8045",1912,1821,2218,77,81,158
"8046",2047,1900,395,82,85,167
"8047",1949,1658,33,54,63,117
"8048",1130,834,201,35,39,74
"8049",2224,2058,374,79,73,152
"8050",2205,2041,49,40,46,86
"8051",1350,1229,1104,40,34,74
"8052",2222,1811,37,57,66,123
"8053",2059,2000,2299,94,105,199
"8054",1841,1753,104,56,53,109
"8055",2045,1905,39,85,95,180
"8056",2259,1921,934,69,96,165
"8057",2051,2007,41,116,122,238
"8058",2201,2113,325,36,38,74
"8059",1434,1341,28,39,41,80
"8060",1650,1554,36,55,54,109
"8061",1813,1712,42,48,42,90
"8062",2028,1931,50,58,61,119
"8063",2044,1948,52,44,48,92
"8064",2259,2209,60,64,69,133
"8065",1913,1742,35,68,77,145
"8066",1522,1432,300,42,47,89
"8067",1437,1307,534,107,117,224
"8068",23,2122,51,33,42,75
"8069",2212,1957,659,102,112,214
"8070",2217,2120,476,37,40,77
"8071",2159,2047,117,34,42,76
"8072",2259,1905,37,94,120,214
"8073",2032,1953,720,37,43,80
"8074",1143,1025,795,38,45,83
"8075",1836,1735,2218,41,35,76
"8076",2157,2042,374,52,57,109
"8077",1959,1820,39,39,50,89
"8078",11,2030,934,141,165,306
"8079",2333,2249,325,128,134,262
"8080",1332,1236,20,97,96,193
"8081",1504,1409,30,34,39,73
"8082",1622,1524,34,57,54,111
"8083",1407,1259,1104,57,64,121
"8084",1231,1138,20,36,38,74
"8085",1332,1235,24,37,35,72
"8086",1559,1500,28,124,120,244
"8087",1502,1407,30,32,37,69
"8088",2045,1952,52,45,52,97
"8089",1522,1426,300,42,41,83
"8090",1239,1136,7,94,101,195
"8091",1344,1237,1104,34,42,76
"8092",2047,2010,720,52,60,112
"8093",1913,1538,1420,48,62,110
"8094",1110,816,944,60,76,136
"8095",1312,1010,1590,53,58,111
"8096",2109,1724,1420,164,168,332
"8097",2346,2005,54,161,127,288
"8098",1102,818,4996,118,138,256
"8099",2150,1903,5183,41,58,99
"8100",2142,1902,5183,33,57,90
"8101",2148,1838,5183,39,33,72
"8102",2209,1913,5183,60,68,128
"8103",2228,1924,5183,79,79,158
"8104",2141,1846,5183,32,41,73
"8105",2151,1907,5183,42,62,104
"8106",2212,1913,5183,63,68,131
"8107",2250,1953,5183,101,108,209
"8108",2224,1939,5183,75,94,169
"8109",2219,1926,5190,199,206,405
"8110",2059,1759,5190,119,119,238
"8111",2006,1713,5190,66,73,139
"8112",2002,1710,5190,62,70,132
"8113",1936,1639,5190,36,39,75
"8114",2258,2008,5190,238,248,486
"8115",2011,1706,5190,71,66,137
"8116",1933,1641,5190,33,41,74
"8117",2129,1801,5190,149,121,270
"8118",2020,1644,5190,80,44,124
"8119",2246,1947,5190,226,227,453
"8120",2110,1815,5190,130,135,265
"8121",2137,1845,5190,157,165,322
"8122",2331,2040,5190,271,280,551
"8123",1338,1049,5225,100,103,203
"8124",1256,1008,5225,58,62,120
"8125",1325,1039,5225,87,93,180
"8126",1310,1019,5225,72,73,145
"8127",1704,1353,5225,306,287,593
"8128",1913,1732,5401,76,72,148
"8129",1107,808,5445,65,68,133
"8130",1158,911,5445,116,131,247
"8131",1108,814,5445,66,74,140
"8132",1113,812,5445,71,72,143
"8133",2120,2012,229,50,62,112
"8134",2147,2025,145,277,275,552
"8135",2218,2057,229,108,107,215
"8136",41,2310,563,251,240,491
"8137",2120,2016,563,50,66,116
"8138",807,704,225,32,49,81
"8139",2128,2005,563,58,55,113
"8140",2206,1921,292,86,92,178
"8141",2238,1954,292,118,125,243
"8142",2240,1944,292,120,115,235
"8143",2251,2006,296,31,39,70
"8144",1256,1009,290,216,224,440
"8145",2124,1828,288,134,133,267
"8146",2245,1950,292,152,152,304
"8147",2250,2000,296,75,80,155
"8148",2051,1753,292,38,35,73
"8149",2257,2010,296,82,90,172
"8150",1514,1218,298,93,92,185
"8151",2229,1922,288,290,274,564
"8152",2345,2036,292,192,178,370
"8153",305,2353,296,292,275,567
"8154",2250,1953,296,37,35,72
"8155",2033,1924,2870,53,59,112
"8156",2025,1925,2870,45,60,105
"8157",2036,1932,2870,56,67,123
"8158",2337,2200,2870,237,215,452
"8159",1343,1225,2958,128,120,248
"8160",1243,1136,2958,68,71,139
"8161",1206,1056,2958,31,31,62
"8162",1253,1103,2958,78,38,116
"8163",1419,1217,2958,164,112,276
"8164",1255,1154,2958,80,89,169
"8165",1026,924,3210,36,44,80
"8166",1120,951,3210,90,71,161
"8167",1120,1007,3210,90,87,177
"8168",1440,1319,3216,100,89,189
"8169",1413,1300,3216,73,70,143
"8170",1445,1333,3216,105,103,208
"8171",1332,1229,3216,32,39,71
"8172",832,731,3265,82,91,173
"8173",851,750,3265,101,110,211
"8174",2326,2122,3328,161,107,268
"8175",2133,2012,3328,48,37,85
"8176",2323,2221,3328,158,166,324
"8177",1027,858,3328,822,803,1625
"8178",2118,2025,3328,33,50,83
"8179",2013,1912,3390,248,257,505
"8180",2000,1900,3390,235,245,480
"8181",1643,1531,3390,38,36,74
"8182",1649,1547,3390,44,52,96
"8183",2124,2021,3390,319,326,645
"8184",2133,1906,3717,33,41,74
"8185",2343,2125,3717,163,180,343
"8186",2344,2102,3717,164,157,321
"8187",2144,1856,3717,44,31,75
"8188",2300,1935,3717,120,70,190
"8189",2339,2024,3717,159,119,278
"8190",2219,1954,3717,79,89,168
"8191",1517,1341,3719,52,51,103
"8192",1626,1510,3719,121,140,261
"8193",1647,1506,3719,142,136,278
"8194",1610,1433,3719,105,103,208
"8195",1458,1338,3719,33,48,81
"8196",1458,1337,3719,33,47,80
"8197",2207,2018,3724,42,33,75
"8198",2235,2109,3724,70,84,154
"8199",2257,2113,3724,92,88,180
"8200",2312,2112,3724,107,87,194
"8201",2158,2025,3724,33,40,73
"8202",2215,2038,3724,50,53,103
"8203",2203,2025,3724,38,40,78
"8204",2211,2040,3724,46,55,101
"8205",1005,835,3762,40,50,90
"8206",1301,1127,3762,216,222,438
"8207",1020,846,3762,55,61,116
"8208",1423,1245,3762,298,300,598
"8209",2108,1858,3786,158,188,346
"8210",2013,1757,3786,103,127,230
"8211",2108,1820,3786,158,150,308
"8212",2003,1738,3786,93,108,201
"8213",1910,1636,3786,40,46,86
"8214",2050,1712,3786,140,82,222
"8215",2237,1749,3786,247,119,366
"8216",2059,1840,3786,149,170,319
"8217",1621,1342,3796,151,142,293
"8218",1425,1203,3796,35,43,78
"8219",1455,1241,3796,65,81,146
"8220",1439,1218,3796,49,58,107
"8221",1424,1157,3796,34,37,71
"8222",1738,1508,3796,228,228,456
"8223",1427,1156,3796,37,36,73
"8224",1435,1208,3796,45,48,93
"8225",1855,1535,3796,305,255,560
"8226",1425,1201,3796,35,41,76
"8227",947,727,3859,37,47,84
"8228",958,729,3859,48,49,97
"8229",1256,1022,3859,226,222,448
"8230",1441,1058,3859,331,258,589
"8231",2211,2053,426,46,48,94
"8232",2201,2054,426,36,49,85
"8233",2250,2137,426,85,92,177
"8234",1315,955,466,230,235,465
"8235",1229,906,466,184,186,370
"8236",2213,1850,1294,63,65,128
"8237",2328,2014,1294,103,129,232
"8238",56,2137,1294,191,212,403
"8239",1501,1317,1534,126,92,218
"8240",1643,1546,1632,63,81,144
"8241",1414,1311,1698,54,66,120
"8242",1815,1712,1925,35,42,77
"8243",1148,1050,1995,78,95,173
"8244",2151,1931,731,47,51,98
"8245",2137,1618,622,101,61,162
"8246",2125,1659,622,89,102,191
"8247",2120,1622,622,80,67,147
"8248",2049,1617,622,49,62,111
"8249",2048,1624,622,48,69,117
"8250",2133,1705,622,93,110,203
"8251",2103,1614,622,63,59,122
"8252",2041,1549,622,41,34,75
"8253",2106,1546,622,66,31,97
"8254",2035,1609,622,35,54,89
"8255",1713,1612,33,33,42,75
"8256",2139,2024,47,61,74,135
"8257",2218,1923,344,73,58,131
"8258",2343,2115,367,46,45,91
"8259",2052,1858,570,55,63,118
"8260",20,1928,582,35,33,68
"8261",1850,1621,746,100,111,211
"8262",1523,1133,788,66,78,144
"8263",1747,1627,795,45,52,97
"8264",2337,2208,815,43,38,81
"8265",53,2058,1488,32,33,65
"8266",2318,2005,1586,65,75,140
"8267",1558,1232,1684,139,127,266
"8268",1358,1257,1711,33,37,70
"8269",2103,1951,1795,88,101,189
"8270",1859,1516,1844,41,46,87
"8271",1759,1321,432,167,176,343
"8272",2038,1811,667,43,41,84
"8273",45,2326,815,111,116,227
"8274",2352,1928,1540,77,93,170
"8275",1058,835,1746,55,70,125
"8276",109,2158,1830,154,173,327
"8277",1704,1255,1832,54,85,139
"8278",1716,1608,33,36,38,74
"8279",1029,926,128,119,126,245
"8280",1419,1317,197,86,92,178
"8281",1802,1441,308,68,71,139
"8282",1803,1557,370,63,57,120
"8283",1512,1417,379,82,82,164
"8284",1819,1636,395,44,36,80
"8285",1912,1815,397,32,50,82
"8286",1953,1546,407,36,31,67
"8287",2250,2146,511,35,41,76
"8288",2113,1850,570,76,55,131
"8289",2238,2129,595,44,59,103
"8290",2237,1728,632,110,93,203
"8291",2342,1950,658,34,45,79
"8292",2205,1959,670,72,64,136
"8293",2216,1648,682,107,73,180
"8294",2052,1841,709,48,57,105
"8295",1825,1610,746,75,100,175
"8296",5,2201,770,63,61,124
"8297",13,2017,1456,98,72,170
"8298",2309,1836,1632,52,56,108
"8299",2118,1658,1676,58,63,121
"8300",2113,1953,1826,38,53,91
"8301",2048,1934,59,96,114,210
"8302",2358,2144,249,58,54,112
"8303",1339,1246,279,52,56,108
"8304",1527,1118,358,48,48,96
"8305",2317,2049,444,67,79,146
"8306",2051,1836,570,54,41,95
"8307",2144,1933,670,51,38,89
"8308",13,2225,770,71,85,156
"8309",119,2142,1488,104,122,226
"8310",46,2134,1492,61,84,145
"8311",2334,1848,1540,59,53,112
"8312",2247,1929,1586,34,39,73
"8313",2027,1906,1795,52,56,108
"8314",939,825,199,34,50,84
"8315",101,2111,216,71,91,162
"8316",1718,1236,382,93,106,199
"8317",2333,2249,399,82,89,171
"8318",1755,1357,458,56,62,118
"8319",321,110,467,208,220,428
"8320",1349,1232,499,44,47,91
"8321",1420,952,510,55,57,112
"8322",2030,1804,667,35,34,69
"8323",1138,838,706,45,53,98
"8324",2359,2205,752,64,75,139
"8325",2304,1950,755,62,60,122
"8326",1419,932,782,38,47,85
"8327",41,2344,1479,153,154,307
"8328",2342,2235,1597,77,85,162
"8329",1400,1001,1753,60,60,120
"8330",1455,1154,1,120,139,259
"8331",1336,1246,197,48,61,109
"8332",1846,1531,308,117,121,238
"8333",2250,1850,407,213,215,428
"8334",2338,2038,500,53,73,126
"8335",1845,1417,532,60,72,132
"8336",2128,1931,670,40,36,76
"8337",1908,1441,810,85,91,176
"8338",2315,2221,1479,72,71,143
"8339",1648,1534,1755,65,69,134
"8340",2032,1542,62,79,74,153
"8341",1114,824,167,60,39,99
"8342",2113,1646,210,33,56,89
"8343",1505,1230,267,45,35,80
"8344",2051,2002,297,33,57,90
"8345",1501,1356,323,41,46,87
"8346",1656,1348,398,47,48,95
"8347",2020,1631,407,63,76,139
"8348",1848,1345,482,58,50,108
"8349",1905,1443,532,80,98,178
"8350",102,2026,582,77,91,168
"8351",2302,2201,597,36,46,82
"8352",1616,1450,599,33,35,68
"8353",2139,1632,682,70,57,127
"8354",52,2026,732,85,96,181
"8355",2324,2013,755,82,83,165
"8356",1852,1404,810,61,54,115
"8357",1351,1210,1522,116,100,216
"8358",22,2107,1523,87,102,189
"8359",2352,2121,1602,55,51,106
"8360",2349,1908,1632,86,88,174
"8361",1420,1308,1711,55,48,103
"8362",1748,1654,6,78,84,162
"8363",1706,1609,35,38,34,72
"8364",2141,2010,47,63,60,123
"8365",2034,1604,62,81,96,177
"8366",1141,718,89,81,78,159
"8367",1645,1536,137,51,66,117
"8368",1028,907,195,34,37,71
"8369",2222,1808,210,102,138,240
"8370",1635,1206,232,156,171,327
"8371",2057,1955,297,39,50,89
"8372",1153,932,309,47,42,89
"8373",2137,1906,344,32,41,73
"8374",1555,1141,432,43,76,119
"8375",1906,1837,520,41,52,93
"8376",2129,1720,532,224,255,479
"8377",1130,749,544,57,64,121
"8378",1705,1546,599,82,91,173
"8379",2241,1954,616,31,39,70
"8380",1700,1542,623,71,67,138
"8381",2216,1811,632,89,136,225
"8382",1911,1750,695,51,50,101
"8383",2251,2146,1423,40,41,81
"8384",2316,2009,1456,41,64,105
"8385",2257,2204,1479,49,54,103
"8386",101,2131,1488,86,111,197
"8387",2024,1855,1511,54,50,104
"8388",1952,1727,1546,44,57,101
"8389",1119,1036,1583,68,81,149
"8390",2254,1845,1632,37,65,102
"8391",1420,1102,1684,41,37,78
"8392",2104,1725,1688,55,70,125
"8393",1621,1459,1755,38,34,72
"8394",2057,1955,1779,128,125,253
"8395",1702,1545,1821,62,65,127
"8396",1936,1523,1832,206,233,439
"8397",2102,1940,5,124,110,234
"8398",1733,1638,6,63,68,131
"8399",1731,1618,33,51,48,99
"8400",2025,1935,35,237,240,477
"8401",2216,2047,47,98,97,195
"8402",2005,1845,59,53,65,118
"8403",1740,1243,60,55,43,98
"8404",2129,1631,62,136,123,259
"8405",1725,1600,137,91,90,181
"8406",2138,2028,150,138,143,281
"8407",25,2112,190,110,132,242
"8408",1521,1421,197,148,156,304
"8409",1731,1413,206,82,73,155
"8410",2352,2147,209,52,57,109
"8411",2133,1648,210,53,58,111
"8412",2058,1529,212,314,314,628
"8413",110,2117,216,90,107,197
"8414",1010,928,220,35,38,73
"8415",1552,1201,226,82,101,183
"8416",1701,1227,232,182,192,374
"8417",8,2041,250,68,91,159
"8418",1600,1254,267,100,59,159
"8419",1702,1458,270,217,213,430
"8420",1519,1417,279,152,147,299
"8421",1308,819,282,38,44,82
"8422",2050,1951,297,32,46,78
"8423",1918,1553,308,144,143,287
"8424",1141,930,309,35,40,75
"8425",115,2108,310,95,128,223
"8426",1815,1358,326,68,63,131
"8427",1313,817,332,53,37,90
"8428",1817,1406,358,212,206,418
"8429",1529,1201,361,82,91,173
"8430",259,38,367,242,248,490
"8431",1433,1326,379,43,31,74
"8432",1808,1240,382,143,110,253
"8433",40,2346,399,149,146,295
"8434",1420,932,408,106,102,208
"8435",1619,1509,409,280,279,559
"8436",245,2228,410,76,93,169
"8437",2342,2239,423,198,204,402
"8438",1814,1323,432,182,178,360
"8439",43,2320,442,125,130,255
"8440",2317,2056,444,67,86,153
"8441",318,50,467,205,200,405
"8442",2230,2141,479,137,146,283
"8443",7,2220,489,85,90,175
"8444",1352,1229,497,208,199,407
"8445",1520,1319,499,130,94,224
"8446",6,2050,500,79,85,164
"8447",1749,1514,509,61,44,105
"8448",2332,2216,511,77,71,148
"8449",1800,1401,534,60,56,116
"8450",1101,956,541,48,56,104
"8451",1405,1154,542,147,144,291
"8452",2127,1725,558,72,75,147
"8453",1125,1014,559,35,49,84
"8454",1140,830,576,73,65,138
"8455",1448,1123,577,83,73,156
"8456",1040,908,595,766,758,1524
"8457",116,20,597,176,191,367
"8458",1740,1608,599,117,113,230
"8459",1954,1640,606,54,55,109
"8460",13,2116,608,113,126,239
"8461",1634,1521,623,45,46,91
"8462",41,2114,644,126,144,270
"8463",2132,1948,670,39,53,92
"8464",2150,1643,682,81,68,149
"8465",1401,1248,683,81,63,144
"8466",1642,1245,686,168,140,308
"8467",2055,1937,695,155,157,312
"8468",1645,1533,697,70,68,138
"8469",1136,819,706,38,34,72
"8470",2058,1832,709,54,48,102
"8471",1518,1407,723,160,157,317
"8472",19,2016,732,52,86,138
"8473",1426,1303,738,71,53,124
"8474",1217,1120,739,102,120,222
"8475",1833,1452,744,98,107,205
"8476",31,2202,752,96,72,168
"8477",21,2125,755,139,155,294
"8478",2000,1854,763,137,139,276
"8479",140,2340,770,158,160,318
"8480",1859,1344,810,68,34,102
"8481",2252,2225,820,77,90,167
"8482",47,2114,1417,88,109,197
"8483",2320,2217,1423,69,72,141
"8484",2123,2037,1441,96,102,198
"8485",139,2214,1456,184,189,373
"8486",1543,1324,1470,261,224,485
"8487",2352,2301,1479,104,111,215
"8488",2123,1755,1497,159,145,304
"8489",2028,1922,1511,58,77,135
"8490",1411,1223,1522,136,113,249
"8491",2316,2225,1533,74,75,149
"8492",105,2049,1540,150,174,324
"8493",1607,1220,1544,126,127,253
"8494",2005,1741,1546,57,71,128
"8495",1742,1403,1548,43,38,81
"8496",1603,1510,1557,52,55,107
"8497",2350,2003,1558,110,126,236
"8498",2307,1927,1586,54,37,91
"8499",1200,832,1590,55,67,122
"8500",1923,1834,1603,34,39,73
"8501",1427,1239,1605,72,49,121
"8502",1426,1353,1620,131,138,269
"8503",24,2213,1625,39,68,107
"8504",1452,1307,1629,89,67,156
"8505",45,2255,1644,102,105,207
"8506",1633,1237,1656,125,87,212
"8507",49,2120,1662,121,110,231
"8508",2220,1824,1676,120,149,269
"8509",1142,1038,1679,61,57,118
"8510",1933,1829,1689,48,54,102
"8511",1632,1516,1695,95,104,199
"8512",958,814,1697,73,34,107
"8513",1715,1522,1714,360,362,722
"8514",2328,2226,1717,62,72,134
"8515",1043,817,1746,40,52,92
"8516",2327,2004,1748,50,59,109
"8517",1608,1417,1750,78,87,165
"8518",1249,1150,1751,185,173,358
"8519",1654,1234,1753,234,219,453
"8520",1655,1534,1755,72,69,141
"8521",1345,1122,1767,104,112,216
"8522",1939,1848,1779,50,58,108
"8523",1921,1818,1783,41,53,94
"8524",1829,1712,1787,94,92,186
"8525",1748,1416,1790,63,71,134
"8526",2029,1918,1795,54,68,122
"8527",2355,2150,1812,39,45,84
"8528",1821,1651,1821,141,131,272
"8529",2217,2054,1826,102,114,216
"8530",9,2032,1830,94,87,181
"8531",1834,1349,1832,144,139,283
"8532",1848,1423,1836,110,113,223
"8533",1910,1527,1844,52,57,109
"8534",131,2235,1846,96,95,191
"8535",1936,1534,1888,153,149,302
"8536",2042,1858,1889,57,68,125
"8537",1627,1514,137,33,44,77
"8538",1740,1457,146,95,87,182
"8539",1337,1217,197,44,32,76
"8540",2051,1716,244,76,91,167
"8541",1919,1759,397,39,34,73
"8542",1952,1554,407,35,39,74
"8543",2334,2100,444,84,90,174
"8544",1653,1212,510,200,197,397
"8545",2234,2009,567,66,69,135
"8546",105,1947,582,80,52,132
"8547",1128,804,586,38,39,77
"8548",2252,2115,595,58,45,103
"8549",37,2338,597,131,143,274
"8550",1637,1504,599,54,49,103
"8551",23,2006,658,75,61,136
"8552",2143,1939,670,50,44,94
"8553",2151,1645,682,82,70,152
"8554",1430,1107,686,36,42,78
"8555",1318,1222,741,38,37,75
"8556",2350,2202,770,48,62,110
"8557",1103,936,799,38,41,79
"8558",2039,1950,1441,52,55,107
"8559",1449,1310,1605,94,80,174
"8560",1145,1054,1679,64,73,137
"8561",1346,937,1753,46,42,88
"8562",2121,1944,1826,46,44,90
"8563",2119,1652,210,39,62,101
"8564",2353,2305,399,102,105,207
"8565",1951,1554,407,34,39,73
"8566",29,2201,467,36,31,67
"8567",2351,2133,489,69,43,112
"8568",1502,1232,546,42,47,89
"8569",2119,1906,570,82,71,153
"8570",1240,1045,1470,63,50,113
"8571",2017,1850,1511,47,45,92
"8572",1426,1252,1572,61,32,93
"8573",1917,1756,1783,37,31,68
"8574",2008,1843,1795,33,33,66
"8575",44,2228,1812,88,83,171
"8576",2116,1944,47,38,34,72
"8577",1801,1607,137,127,97,224
"8578",1501,1401,323,41,51,92
"8579",2102,1724,407,105,129,234
"8580",2137,2034,423,36,42,78
"8581",2304,2045,444,54,75,129
"8582",1212,1002,542,39,32,71
"8583",1124,717,544,54,32,86
"8584",2044,1842,570,47,47,94
"8585",120,18,597,174,183,357
"8586",1725,1550,697,110,85,195
"8587",25,2047,1488,45,62,107
"8588",1457,1100,1544,63,47,110
"8589",2024,1831,1545,39,41,80
"8590",24,2115,1602,106,115,221
"8591",109,2355,47,276,285,561
"8592",1939,1802,137,230,212,442
"8593",2144,1706,210,72,76,148
"8594",1451,1020,232,51,65,116
"8595",1419,1227,270,59,62,121
"8596",1633,1538,320,99,83,182
"8597",31,2343,399,145,143,288
"8598",2235,1954,567,72,54,126
"8599",2126,1925,570,94,90,184
"8600",1656,1534,599,78,79,157
"8601",1559,1249,686,130,144,274
"8602",1507,1357,738,77,72,149
"8603",1732,1617,795,35,42,77
"8604",1329,1224,1514,51,54,105
"8605",1358,1246,1605,48,56,104
"8606",1540,1411,1695,50,41,91
"8607",1935,1834,1779,51,44,95
"8608",2009,1848,1795,39,38,77
"8609",1733,1551,1821,98,71,169
"8610",2235,1920,1825,163,150,313
"8611",1742,1644,6,72,74,146
"8612",1812,1444,308,78,74,152
"8613",24,1959,310,44,59,103
"8614",2137,1753,407,140,158,298
"8615",2015,1817,421,31,32,63
"8616",2056,2006,479,33,41,74
"8617",1906,1417,532,81,72,153
"8618",1500,1216,546,40,31,71
"8619",233,104,595,279,274,553
"8620",2356,1924,632,189,209,398
"8621",234,2233,658,206,208,414
"8622",14,1947,732,47,57,104
"8623",1100,949,799,35,54,89
"8624",2211,1749,806,65,58,123
"8625",1304,1108,1407,109,108,217
"8626",2358,2045,1456,83,100,183
"8627",19,2044,1492,34,34,68
"8628",1315,1142,1522,80,72,152
"8629",13,1951,1540,98,116,214
"8630",229,2323,1586,256,273,529
"8631",8,2127,1602,71,57,128
"8632",2357,1921,1632,94,101,195
"8633",1237,1020,1767,36,50,86
"8634",2039,1941,1779,110,111,221
"8635",1942,1838,5,44,48,92
"8636",2136,1632,210,56,42,98
"8637",2242,2010,444,32,40,72
"8638",1635,1513,599,52,58,110
"8639",49,2111,644,134,141,275
"8640",1905,1421,810,74,71,145
"8641",35,2114,1492,50,64,114
"8642",2029,1901,1511,59,56,115
"8643",1052,1008,1583,41,53,94
"8644",1238,908,1590,93,103,196
"8645",1205,1032,52,175,167,342
"8646",2053,1833,570,56,38,94
"8647",8,2303,597,108,114,222
"8648",1410,1237,1629,47,37,84
"8649",140,2225,1846,105,85,190
"8650",2135,1926,670,42,31,73
"8651",2357,2158,770,55,58,113
"8652",1920,1835,1603,31,40,71
"8653",2045,1656,1688,36,41,77
"8654",156,2308,1846,121,128,249
"8655",2034,1926,150,74,81,155
"8656",1909,1523,326,122,148,270
"8657",2112,1716,407,115,121,236
"8658",2029,1827,570,32,32,64
"8659",2245,2108,595,51,38,89
"8660",2040,1724,1648,79,99,178
"8661",2110,1653,1688,61,38,99
"8662",24,2018,1776,46,63,109
"8663",1332,1012,1,37,37,74
"8664",2334,2122,209,34,32,66
"8665",1735,1532,370,35,32,67
"8666",2030,1623,407,73,68,141
"8667",2201,2104,423,60,72,132
"8668",1351,1230,499,46,45,91
"8669",10,2027,658,62,82,144
"8670",2137,1642,682,68,67,135
"8671",40,2330,815,106,120,226
"8672",53,2121,1488,73,96,169
"8673",1339,1112,1646,34,42,76
"8674",1900,1747,1787,125,127,252
"8675",2314,2000,1830,39,55,94
"8676",2220,1757,62,195,209,404
"8677",1057,633,89,37,33,70
"8678",1451,1256,270,91,91,182
"8679",916,806,403,36,41,77
"8680",1805,1241,408,345,291,636
"8681",1919,1840,520,59,55,114
"8682",2036,1829,570,44,34,78
"8683",2209,1950,670,81,55,136
"8684",2347,2244,1717,86,90,176
"8685",1541,1325,1750,54,33,87
"8686",1837,1406,1836,60,52,112
"8687",1431,1107,1868,221,222,443
"8688",1724,1603,33,44,33,77
"8689",2001,1857,150,41,52,93
"8690",1623,1046,212,39,31,70
"8691",1701,1414,267,161,139,300
"8692",2229,1948,344,84,83,167
"8693",2346,2252,399,95,92,187
"8694",2012,1611,407,55,56,111
"8695",2317,2052,444,67,82,149
"8696",2307,2119,595,73,49,122
"8697",35,2232,770,93,92,185
"8698",2311,2215,1423,60,70,130
"8699",2123,2037,1441,96,102,198
"8700",47,2223,1625,62,78,140
"8701",1350,1122,1646,45,52,97
"8702",2115,1651,1688,66,36,102
"8703",1129,840,1746,86,75,161
"8704",2013,1857,1795,38,47,85
"8705",1809,1708,1798,74,88,162
"8706",2131,2011,47,53,61,114
"8707",1952,1738,146,227,248,475
"8708",1629,1048,212,45,33,78
"8709",2105,2013,297,47,68,115
"8710",2143,1916,344,38,51,89
"8711",1516,1418,379,86,83,169
"8712",1655,1157,382,66,63,129
"8713",244,2228,410,75,93,168
"8714",2054,1954,417,34,44,78
"8715",1451,1325,499,101,100,201
"8716",1234,1027,542,56,57,113
"8717",1651,1336,546,151,111,262
"8718",2112,1901,570,75,66,141
"8719",36,1956,582,51,61,112
"8720",2325,2203,597,59,48,107
"8721",2134,1657,632,47,62,109
"8722",2354,1950,658,46,45,91
"8723",2315,1836,682,166,181,347
"8724",2358,1924,732,31,34,65
"8725",1818,1535,746,68,65,133
"8726",1519,1121,788,62,66,128
"8727",2330,2226,1423,79,81,160
"8728",2110,2023,1441,83,88,171
"8729",158,2238,1492,133,148,281
"8730",118,2014,1632,181,154,335
"8731",1543,1259,1646,158,149,307
"8732",119,21,1717,173,187,360
"8733",1349,1053,1746,226,208,434
"8734",53,2222,1812,97,77,174
"8735",114,2204,1846,79,64,143
"8736",2207,1800,412,71,58,129
"8737",2026,1811,709,32,41,73
"8738",2050,1941,1705,76,81,157
"8739",13,2020,426,43,60,103
"8740",1930,1800,850,46,55,101
"8741",1907,1403,810,77,53,130
"8742",1956,1842,850,72,97,169
"8743",2259,1925,1552,41,35,76
"8744",1747,1623,1787,49,37,86
"8745",1923,1516,1844,63,41,104
"8746",2005,1529,62,56,64,120
"8747",931,820,128,53,50,103
"8748",1629,1404,146,41,49,90
"8749",2132,1752,244,118,127,245
"8750",1637,1200,382,84,90,174
"8751",1657,1353,398,50,53,103
"8752",2259,2204,597,38,64,102
"8753",2315,1928,644,40,33,73
"8754",2325,2137,670,126,157,283
"8755",1443,1121,1448,52,56,108
"8756",2030,1933,1603,84,77,161
"8757",1439,1325,1605,80,95,175
"8758",1439,1329,1629,89,109,198
"8759",1047,806,1746,47,41,88
"8760",2119,2005,47,37,55,92
"8761",1452,1221,270,84,56,140
"8762",1727,1531,370,46,56,102
"8763",1,2221,489,62,86,148
"8764",2046,1843,570,55,63,118
"8765",14,2316,597,116,136,252
"8766",2222,2032,670,66,92,158
"8767",1324,1221,723,46,46,92
"8768",1438,1329,738,54,59,113
"8769",38,2244,752,69,84,153
"8770",2040,1930,763,172,165,337
"8771",1945,1637,1536,38,47,85
"8772",1859,1632,1750,51,32,83
"8773",1717,1237,60,34,37,71
"8774",59,2049,210,261,299,560
"8775",2058,1954,297,32,49,81
"8776",1951,1555,407,59,65,124
"8777",2333,1945,658,32,40,72
"8778",2338,2013,1748,60,63,123
"8779",2005,1914,1779,83,89,172
"8780",1740,1554,697,87,59,146
"8781",2112,1744,786,259,249,508
"8782",2113,2027,1441,31,37,68
"8783",2049,1917,1511,70,72,142
"8784",2001,1620,1648,49,35,84
"8785",2019,1519,62,70,54,124
"8786",2356,1926,732,37,36,73
"8787",5,2253,815,84,108,192
"8788",2011,1655,1536,61,65,126
"8789",1058,939,1623,65,54,119
"8790",2340,1843,1632,83,58,141
"8791",2135,1833,8,159,163,322
"8792",1959,1626,8,63,36,99
"8793",2240,1937,54,80,86,166
"8794",1053,750,810,43,50,93
"8795",1106,751,810,56,51,107
"8796",1930,1537,1409,59,57,116
"8797",2213,1905,54,53,54,107
"8798",1102,813,810,52,73,125
"8799",1345,1038,1590,93,91,184
"8800",2235,1939,8,208,229,437
"8801",2156,1856,54,36,45,81
"8802",2322,1912,54,122,61,183
"8803",2008,1716,8,61,86,147
"8804",2225,1926,54,65,75,140
"8805",2154,1856,54,34,45,79
"8806",2110,2030,1493,40,45,85
"8807",1642,1245,625,52,60,112
"8808",1918,1603,3486,48,58,106
"8809",2346,2300,55,96,100,196
"8810",1619,1314,19,39,49,88
"8811",1354,1259,1283,34,34,68
"8812",1615,1308,926,40,38,78
"8813",111,2254,1553,56,59,115
"8814",21,2211,2525,61,76,137
"8815",1936,1840,316,36,45,81
"8816",1910,1756,125,35,36,71
"8817",944,834,1240,54,59,113
"8818",1931,1456,544,31,31,62
"8819",1,2040,45,91,95,186
"8820",1919,1801,352,104,111,215
"8821",1748,1630,618,153,160,313
"8822",2341,2037,291,41,52,93
"8823",1556,1455,23,86,90,176
"8824",1708,1254,11,108,114,222
"8825",1740,1702,473,35,37,72
"8826",2308,2237,1178,98,107,205
"8827",2111,2013,332,36,38,74
"8828",2110,2029,1493,40,44,84
"8829",42,2046,49,47,51,98
"8830",1700,1256,625,70,71,141
"8831",12,2011,677,137,141,278
"8832",1955,1633,3486,85,88,173
"8833",2329,2242,55,79,82,161
"8834",1612,1516,34,42,46,88
"8835",1714,1617,36,74,77,151
"8836",1909,1815,42,99,105,204
"8837",2043,1950,46,133,140,273
"8838",2349,2257,58,144,147,291
"8839",2151,2031,1863,51,66,117
"8840",1802,1305,293,212,190,402
"8841",2315,1632,544,255,127,382
"8842",2302,1944,45,32,39,71
"8843",1456,1133,376,31,38,69
"8844",1818,1513,19,158,168,326
"8845",1621,1528,27,56,58,114
"8846",2123,2032,39,178,182,360
"8847",1820,1730,295,45,50,95
"8848",2338,2248,1212,48,53,101
"8849",1826,1523,926,171,173,344
"8850",1848,1727,352,73,77,150
"8851",20,2301,794,60,66,126
"8852",35,2322,267,95,102,197
"8853",24,2116,291,84,91,175
"8854",2255,1950,1495,315,330,645
"8855",2006,1753,198,51,68,119
"8856",51,2243,1553,36,48,84
"8857",1824,1718,213,34,33,67
"8858",129,34,834,234,239,473
"8859",2214,2019,164,44,39,83
"8860",1741,1627,715,36,37,73
"8861",32,2016,985,37,36,73
"8862",2052,1944,41,97,99,196
"8863",56,12,1039,171,177,348
"8864",2212,2021,2904,167,181,348
"8865",1835,1714,35,45,44,89
"8866",2308,2225,55,58,65,123
"8867",1622,1310,19,42,45,87
"8868",2326,2231,1212,36,36,72
"8869",1442,1330,653,152,150,302
"8870",36,2312,794,76,77,153
"8871",1631,1419,948,41,54,95
"8872",1255,1159,1167,125,134,259
"8873",1327,1135,1222,57,60,117
"8874",1141,849,297,41,59,100
"8875",1852,1802,22,52,62,114
"8876",2029,1902,1401,34,42,76
"8877",2320,2009,723,65,79,144
"8878",1539,1412,3617,139,137,276
"8879",2133,1914,1789,33,39,72
"8880",2016,1918,21,46,48,94
"8881",2317,1913,935,42,58,100
"8882",2245,2201,1493,135,136,271
"8883",951,812,629,36,52,88
"8884",2335,1944,677,100,114,214
"8885",1925,1831,46,55,61,116
"8886",1904,1743,352,89,93,182
"8887",210,50,794,170,175,345
"8888",1951,1739,198,36,54,90
"8889",2349,2159,164,139,139,278
"8890",1523,1332,1222,173,177,350
"8891",1910,1803,125,35,43,78
"8892",1745,1633,715,40,43,83
"8893",2251,2208,1039,46,53,99
"8894",2251,1857,677,56,67,123
"8895",2030,1937,52,35,37,72
"8896",2029,1944,2807,34,39,73
"8897",2041,1933,1559,36,33,69
"8898",1650,1258,625,60,73,133
"8899",2006,1536,544,66,71,137
"8900",2224,2118,230,34,43,77
"8901",2357,2226,794,37,31,68
"8902",2222,2125,834,47,50,97
"8903",1939,1854,3574,59,64,123
"8904",2337,2223,1374,57,63,120
"8905",2112,2033,1493,42,48,90
"8906",1330,1249,2797,65,69,134
"8907",1231,1105,9,31,45,76
"8908",1622,1418,1005,52,38,90
"8909",1552,1459,24,177,179,356
"8910",1721,1632,38,51,62,113
"8911",1614,1528,1104,34,38,72
"8912",2345,2254,47,200,204,404
"8913",2105,1959,1559,60,59,119
"8914",1011,657,576,36,42,78
"8915",1942,1634,1495,122,134,256
"8916",1532,1448,243,92,88,180
"8917",1457,1407,1191,37,37,74
"8918",1916,1831,3574,36,41,77
"8919",1506,1313,939,126,133,259
"8920",1902,1808,46,32,38,70
"8921",1934,1502,544,34,37,71
"8922",1644,1330,376,139,155,294
"8923",2135,2046,47,70,76,146
"8924",2346,2256,1212,56,61,117
"8925",1938,1825,512,43,35,78
"8926",34,2301,794,74,66,140
"8927",2037,1943,316,97,108,205
"8928",2055,1757,37,45,52,97
"8929",1842,1724,35,52,54,106
"8930",2129,2030,332,54,55,109
"8931",2242,2117,1405,32,42,74
"8932",1400,1206,199,65,61,126
"8933",2050,1902,254,105,112,217
"8934",1902,1539,3486,32,34,66
"8935",1649,1601,31,34,36,70
"8936",2048,2008,43,88,98,186
"8937",2303,2222,55,53,62,115
"8938",1642,1540,36,42,40,82
"8939",1959,1906,48,59,66,125
"8940",2137,2042,56,42,42,84
"8941",2329,2238,60,64,68,132
"8942",1827,1648,33,47,48,95
"8943",2120,1656,544,140,151,291
"8944",2321,2211,230,91,96,187
"8945",2355,2229,794,35,34,69
"8946",119,2352,267,139,132,271
"8947",1945,1830,125,70,70,140
"8948",1754,1639,715,49,49,98
"8949",1458,1342,990,68,67,135
"8950",2016,1903,41,61,58,119
"8951",1335,1133,939,35,33,68
"8952",2300,2004,37,170,179,349
"8953",2159,2033,2424,44,53,97
"8954",1908,1817,22,68,77,145
"8955",1636,1541,36,36,41,77
"8956",2034,1912,1401,39,52,91
"8957",1906,1819,248,36,39,75
"8958",2138,2032,3818,43,52,95
"8959",1920,1818,1292,35,38,73
"8960",1352,1227,3617,32,32,64
"8961",2357,2054,3743,62,74,136
"8962",2214,2139,3482,79,84,163
"8963",1816,1627,1918,111,122,233
"8964",2329,2035,269,44,55,99
"8965",2229,2117,3704,39,47,86
"8966",1620,1445,1005,50,65,115
"8967",2038,1947,52,43,47,90
"8968",1345,1253,54,50,53,103
"8969",2113,1709,2196,133,164,297
"8970",1424,1310,990,34,35,69
"8971",1223,1109,462,48,44,92
"8972",1956,1805,2904,31,45,76
"8973",1555,1300,3418,45,55,100
"8974",22,2307,1374,102,107,209
"8975",2103,2017,1493,33,32,65
"8976",26,2046,49,31,51,82
"8977",2004,1656,3486,94,111,205
"8978",2320,2238,55,70,78,148
"8979",1016,918,8,76,78,154
"8980",1454,1404,28,59,64,123
"8981",1759,1709,34,149,159,308
"8982",2157,2059,46,207,209,416
"8983",1933,1843,48,33,43,76
"8984",1529,1055,293,59,60,119
"8985",2001,1700,19,261,275,536
"8986",2058,2005,47,33,35,68
"8987",2346,2250,1212,56,55,111
"8988",1451,1403,1283,91,98,189
"8989",1639,1339,926,64,69,133
"8990",2105,2000,1559,60,60,120
"8991",4,2244,794,44,49,93
"8992",2128,1817,1495,228,237,465
"8993",1953,1738,198,38,53,91
"8994",1505,1412,23,35,47,82
"8995",2044,1947,213,174,182,356
"8996",2327,2236,834,112,121,233
"8997",1036,941,2002,76,86,162
"8998",1450,1412,243,50,52,102
"8999",2340,2306,1178,130,136,266
"9000",2157,2052,41,162,167,329
"9001",35,2345,1039,150,150,300
"9002",1452,1407,1191,32,37,69
"9003",2004,1819,2904,39,59,98
"9004",1854,1742,35,64,72,136
"9005",2131,2031,332,56,56,112
"9006",1540,1444,1860,35,39,74
"9007",4,1949,677,129,119,248
"9008",2008,1621,3486,98,76,174
"9009",1129,1031,16,34,31,65
"9010",1350,1249,24,55,49,104
"9011",1605,1515,34,35,45,80
"9012",1814,1708,42,44,38,82
"9013",2035,1939,52,40,39,79
"9014",1454,1323,15,99,108,207
"9015",1615,1528,1104,35,38,73
"9016",1603,1511,27,38,41,79
"9017",2106,2011,47,41,41,82
"9018",1828,1732,295,53,52,105
"9019",40,2328,794,80,93,173
"9020",1815,1459,1495,35,39,74
"9021",1638,1419,948,48,54,102
"9022",1137,1037,1167,47,52,99
"9023",1707,1548,2106,47,33,80
"9024",2238,2150,1039,33,35,68
"9025",1356,1216,939,56,76,132
"9026",1615,1316,1202,65,71,136
"9027",1045,943,1628,130,133,263
"9028",1538,1441,1860,33,36,69
"9029",2119,2040,1493,49,55,104
"9030",1620,1537,2797,235,237,472
"9031",1319,1128,9,79,68,147
"9032",1349,1138,199,54,33,87
"9033",1309,1118,629,234,238,472
"9034",2020,1711,3486,110,126,236
"9035",2251,2207,55,41,47,88
"9036",1314,1215,3744,49,35,84
"9037",1144,1052,16,49,52,101
"9038",1334,1238,20,99,98,197
"9039",1423,1306,24,88,66,154
"9040",1436,1342,28,41,42,83
"9041",1705,1612,38,35,42,77
"9042",1845,1738,40,105,98,203
"9043",2055,2002,42,205,212,417
"9044",1924,1830,46,54,60,114
"9045",2203,2114,58,38,44,82
"9046",829,658,1636,79,43,122
"9047",1427,1255,770,72,65,137
"9048",1621,1458,1229,51,53,104
"9049",2214,2046,1863,74,81,155
"9050",1450,1306,15,95,91,186
"9051",1543,1455,214,358,355,713
"9052",1516,1105,293,46,70,116
"9053",2003,1558,544,63,93,156
"9054",2320,1957,45,50,52,102
"9055",1633,1327,19,53,62,115
"9056",1257,1146,3,182,166,348
"9057",2257,2204,47,152,154,306
"9058",1835,1739,295,60,59,119
"9059",1435,1318,1283,75,53,128
"9060",1704,1559,441,54,59,113
"9061",1622,1309,926,47,39,86
"9062",1429,1320,653,139,140,279
"9063",2152,2045,1559,107,105,212
"9064",1807,1649,352,32,39,71
"9065",1632,1520,618,77,90,167
"9066",2,2236,794,42,41,83
"9067",1235,1114,863,80,74,154
"9068",9,2254,267,69,74,143
"9069",1440,1122,7,80,87,167
"9070",1813,1451,1495,33,31,64
"9071",53,2252,1553,38,57,95
"9072",108,2306,2525,108,131,239
"9073",1519,1407,23,49,42,91
"9074",1342,1233,527,77,68,145
"9075",2220,2027,164,50,47,97
"9076",1929,1816,125,54,56,110
"9077",208,2218,985,133,158,291
"9078",1607,1521,1191,107,111,218
"9079",1520,1329,1094,45,54,99
"9080",2104,1800,37,54,55,109
"9081",1252,1123,848,112,103,215
"9082",113,2359,1374,153,159,312
"9083",2109,2030,1493,39,45,84
"9084",1257,1213,2797,32,33,65
"9085",2300,2131,1405,50,56,106
"9086",1653,1509,1005,83,89,172
"9087",1748,1359,625,118,134,252
"9088",18,2042,677,143,172,315
"9089",2049,2007,43,89,97,186
"9090",1520,1419,28,85,79,164
"9091",1729,1636,38,59,66,125
"9092",1740,1647,40,40,47,87
"9093",2220,2124,58,55,54,109
"9094",2304,2216,60,39,46,85
"9095",2200,2044,1863,60,79,139
"9096",1528,1054,293,58,59,117
"9097",2,1959,544,302,334,636
"9098",2315,1953,45,45,48,93
"9099",1910,1812,39,45,42,87
"9100",2125,2030,47,60,60,120
"9101",1841,1744,295,66,64,130
"9102",2053,1943,1559,48,43,91
"9103",2359,2248,267,59,68,127
"9104",2356,2144,2525,36,49,85
"9105",2235,2139,834,60,64,124
"9106",2244,2045,164,74,65,139
"9107",1909,1753,125,34,33,67
"9108",2202,2133,1178,32,43,75
"9109",2105,2007,41,110,122,232
"9110",2106,1811,37,56,66,122
"9111",1906,1747,35,76,77,153
"9112",1654,1610,31,39,45,84
"9113",2246,2203,55,36,43,79
"9114",1332,1233,24,37,33,70
"9115",2015,1923,46,105,113,218
"9116",2021,1930,48,81,90,171
"9117",2224,2134,52,149,154,303
"9118",2334,2248,60,69,78,147
"9119",2343,2253,1212,53,58,111
"9120",2244,2131,230,54,56,110
"9121",1610,1315,926,35,45,80
"9122",1549,1428,618,34,38,72
"9123",13,2248,794,53,53,106
"9124",2332,2218,267,32,38,70
"9125",2206,2112,834,31,37,68
"9126",2202,2134,1178,32,44,76
"9127",2250,2205,1039,45,50,95
"9128",1936,1851,3574,56,61,117
"9129",25,2132,971,45,57,102
"9130",2333,2211,1374,53,51,104
"9131",1943,1757,2606,43,52,95
"9132",1448,1403,3639,33,38,71
"9133",1211,1125,237,131,145,276
"9134",1943,1854,552,43,54,97
"9135",1350,1220,1069,45,55,100
"9136",1554,1503,284,34,38,72
"9137",2155,2048,3818,60,68,128
"9138",2000,1846,2516,90,96,186
"9139",2012,1711,925,62,81,143
"9140",1523,1152,3479,73,67,140
"9141",2352,2056,3743,57,76,133
"9142",2317,2100,2628,37,45,82
"9143",2022,1925,21,52,55,107
"9144",2119,2021,966,39,41,80
"9145",1950,1846,2030,40,46,86
"9146",1419,1316,3626,64,71,135
"9147",32,2142,269,107,122,229
"9148",1228,1138,20,33,38,71
"9149",2040,1950,52,45,50,95
"9150",2048,2011,2807,53,66,119
"9151",2206,2017,164,36,37,73
"9152",2001,1856,41,46,51,97
"9153",2003,1808,2904,38,48,86
"9154",2120,2040,1493,50,55,105
"9155",1957,1809,254,52,59,111
"9156",1705,1515,1005,95,95,190
"9157",1648,1601,31,33,36,69
"9158",1711,1617,38,41,47,88
"9159",2027,1936,52,32,36,68
"9160",2314,2222,58,109,112,221
"9161",1833,1717,352,58,67,125
"9162",2136,2035,316,156,160,316
"9163",2249,2159,1039,44,44,88
"9164",1932,1844,3574,52,54,106
"9165",1347,1153,939,47,53,100
"9166",1838,1722,35,48,52,100
"9167",2107,2028,1493,37,43,80
"9168",1715,1529,1005,105,109,214
"9169",1706,1254,625,76,69,145
"9170",2245,1853,677,50,63,113
"9171",1835,1741,44,35,41,76
"9172",1648,1528,1229,78,83,161
"9173",2003,1516,544,63,51,114
"9174",18,2309,794,58,74,132
"9175",2335,2224,267,35,44,79
"9176",1630,1409,948,40,44,84
"9177",2223,2041,164,53,61,114
"9178",1748,1623,715,43,33,76
"9179",1530,1312,1094,55,37,92
"9180",2017,1829,2904,52,69,121
"9181",2333,2221,1374,53,61,114
"9182",1709,1316,625,79,91,170
"9183",2044,1954,52,49,54,103
"9184",2153,2040,1863,53,75,128
"9185",1859,1809,39,34,39,73
"9186",1806,1713,295,31,33,64
"9187",2043,1947,1559,38,47,85
"9188",2045,1926,352,190,196,386
"9189",1810,1725,473,65,60,125
"9190",1352,1201,939,52,61,113
"9191",2317,2021,37,187,196,383
"9192",2124,2033,332,49,58,107
"9193",1603,1420,1005,33,40,73
"9194",2337,1939,677,102,109,211
"9195",1332,1244,3744,67,64,131
"9196",1910,1815,46,40,45,85
"9197",2151,2053,48,171,173,344
"9198",1740,1538,1229,130,93,223
"9199",2117,2029,2807,82,84,166
"9200",2328,1856,544,268,271,539
"9201",1552,1209,376,87,74,161
"9202",112,2254,1553,57,59,116
"9203",2159,2059,316,179,184,363
"9204",759,705,859,39,45,84
"9205",1747,1635,715,42,45,87
"9206",128,2119,985,93,99,192
"9207",2204,2139,1178,34,49,83
"9208",2330,2147,2904,245,267,512
"9209",2244,1923,2008,174,163,337
"9210",2033,1726,2008,37,46,83
"9211",2032,1716,2008,38,36,74
"9212",2115,1804,2008,85,84,169
"9213",2129,1824,2008,99,104,203
"9214",2035,1729,2008,41,49,90
"9215",2311,2206,2009,43,46,89
"9216",2302,2208,2009,36,48,84
"9217",1735,1423,2010,50,48,98
"9218",1753,1439,2010,68,64,132
"9219",1749,1636,2013,116,116,232
"9220",1615,1521,2025,36,46,82
"9221",2215,1910,2025,100,100,200
"9222",2127,1824,2025,52,54,106
"9223",2331,1942,2025,176,132,308
"9224",2335,2013,2025,180,163,343
"9225",2215,1859,2025,100,89,189
"9226",2300,1931,2025,145,121,266
"9227",1045,843,2026,81,83,164
"9228",2345,2015,2027,53,55,108
"9229",39,2053,2027,113,103,216
"9230",2336,2014,2027,50,64,114
"9231",1614,1519,2033,52,54,106
"9232",1208,809,2035,59,44,103
"9233",2221,2044,2042,44,44,88
"9234",2225,2046,2042,48,46,94
"9235",2232,2100,2042,55,60,115
"9236",2234,2051,2042,57,51,108
"9237",2230,2049,2042,53,49,102
"9238",2258,2116,2042,75,71,146
"9239",2230,2058,2042,52,58,110
"9240",2223,1902,2044,68,72,140
"9241",2259,1926,2044,104,96,200
"9242",2346,1932,2044,151,102,253
"9243",2312,1941,2044,107,111,218
"9244",2243,1902,2044,78,72,150
"9245",2222,1849,2044,57,59,116
"9246",2248,1937,2044,83,107,190
"9247",2220,1859,2044,55,69,124
"9248",1544,1425,2048,32,32,64
"9249",1601,1438,2048,47,45,92
"9250",1543,1427,2048,31,34,65
"9251",1600,1431,2048,48,38,86
"9252",1846,1721,2048,224,216,440
"9253",2347,1953,2050,67,58,125
"9254",52,2101,2050,123,126,249
"9255",2346,2013,2050,57,78,135
"9256",21,2043,2050,92,108,200
"9257",2334,1933,2050,45,38,83
"9258",1021,828,2056,39,43,82
"9259",1139,1043,2058,65,63,128
"9260",1058,1010,2058,33,42,75
"9261",1109,1018,2058,42,48,90
"9262",2335,2227,2062,250,252,502
"9263",2025,1916,2062,60,61,121
"9264",2054,1953,2062,89,98,187
"9265",2052,1949,2062,87,94,181
"9266",2154,2046,2062,132,131,263
"9267",1704,1558,2069,40,38,78
"9268",28,2128,2076,34,33,67
"9269",1126,1005,2079,61,55,116
"9270",1337,1233,2082,62,58,120
"9271",1337,1228,2082,62,53,115
"9272",1844,1515,2105,135,140,275
"9273",1731,1349,2105,67,59,126
"9274",1941,1551,2105,192,176,368
"9275",1829,1506,2105,105,111,216
"9276",2342,2248,2131,87,88,175
"9277",2300,2207,2131,40,47,87
"9278",941,834,2132,49,64,113
"9279",932,825,2132,39,50,89
"9280",1050,1006,2141,36,46,82
"9281",1829,1555,2147,87,65,152
"9282",1740,1525,2147,38,35,73
"9283",1806,1532,2147,64,42,106
"9284",1740,1525,2147,38,35,73
"9285",1958,1841,2162,119,121,240
"9286",1845,1713,2162,39,33,72
"9287",1836,1714,2162,37,34,71
"9288",1836,1714,2162,32,34,66
"9289",1913,1749,2162,52,54,106
"9290",13,2033,2171,70,88,158
"9291",21,2039,2171,78,94,172
"9292",42,2044,2171,99,99,198
"9293",1543,1407,2174,73,62,135
"9294",1550,1422,2174,85,87,172
"9295",1522,1347,2174,57,52,109
"9296",1055,941,2176,41,31,72
"9297",1229,1129,2176,135,139,274
"9298",1626,1513,2196,46,48,94
"9299",1835,1510,2198,61,55,116
"9300",1346,1219,2200,48,39,87
"9301",1342,1216,2200,44,36,80
"9302",1348,1232,2200,50,52,102
"9303",1950,1849,2212,60,59,119
"9304",2008,1907,2212,78,77,155
"9305",1957,1858,2212,67,68,135
"9306",2009,1910,2212,79,80,159
"9307",2040,1929,2212,112,99,211
"9308",2310,2156,2212,260,246,506
"9309",1523,1402,2213,40,42,82
"9310",1618,1453,2213,78,78,156
"9311",1509,1348,2223,80,58,138
"9312",1432,1337,2223,43,47,90
"9313",1525,1331,2231,35,41,76
"9314",1240,903,2240,101,103,204
"9315",1227,845,2240,93,85,178
"9316",1715,1613,2242,42,42,84
"9317",1452,1241,2249,198,156,354
"9318",1324,1143,2249,108,98,206
"9319",4,2055,2253,89,90,179
"9320",958,903,2254,56,63,119
"9321",1205,1040,2254,183,160,343
"9322",935,833,2259,56,63,119
"9323",2255,2203,2261,45,43,88
"9324",2326,2231,2261,79,76,155
"9325",2304,2216,2261,55,61,116
"9326",2242,2157,2261,38,42,80
"9327",2323,2237,2261,73,82,155
"9328",2125,2024,2266,48,64,112
"9329",2135,2035,2266,58,75,133
"9330",2222,2112,2266,105,112,217
"9331",2112,2003,2266,35,43,78
"9332",1536,1157,2268,67,67,134
"9333",1756,1607,2274,67,72,139
"9334",1718,1527,2274,34,37,71
"9335",1729,1538,2274,40,43,83
"9336",1830,1615,2274,106,85,191
"9337",2117,1754,2276,65,59,124
"9338",2056,1746,2276,47,61,108
"9339",2058,1719,2276,45,34,79
"9340",1838,1619,2278,65,49,114
"9341",2222,2037,2280,59,42,101
"9342",2156,2028,2280,33,33,66
"9343",2215,2053,2280,36,53,89
"9344",2327,2202,2280,113,122,235
"9345",2207,2040,2280,33,40,73
"9346",2221,2056,2280,47,56,103
"9347",30,2106,2288,67,66,133
"9348",27,2058,2288,64,58,122
"9349",51,2127,2292,63,77,140
"9350",1950,1630,2298,60,60,120
"9351",1131,944,2302,44,50,94
"9352",1708,1512,2302,381,378,759
"9353",1146,1002,2302,58,68,126
"9354",1449,1338,2304,37,43,80
"9355",1500,1348,2304,48,53,101
"9356",1905,1534,2317,88,79,167
"9357",1854,1534,2317,36,46,82
"9358",1914,1530,2317,57,44,101
"9359",1225,814,2320,81,59,140
"9360",1835,1530,2334,75,70,145
"9361",1818,1511,2334,56,51,107
"9362",2023,1715,2334,181,175,356
"9363",2105,1740,2334,228,215,443
"9364",1912,1556,2334,115,111,226
"9365",1827,1519,2334,70,74,144
"9366",1800,1455,2334,43,50,93
"9367",1759,1442,2334,42,37,79
"9368",1643,1453,2336,44,33,77
"9369",1714,1544,2336,59,62,121
"9370",1454,1145,2340,67,80,147
"9371",1047,938,2342,45,38,83
"9372",1430,1058,2344,33,38,71
"9373",1457,1127,2344,65,77,142
"9374",1746,1349,2344,236,219,455
"9375",1856,1715,2346,64,65,129
"9376",2029,1837,2346,157,147,304
"9377",2039,1857,2346,149,155,304
"9378",2310,2204,2357,48,49,97
"9379",2227,2054,2376,164,169,333
"9380",2048,1910,2376,61,65,126
"9381",2116,1945,2376,87,100,187
"9382",1804,1500,2380,32,40,72
"9383",1804,1503,2380,32,43,75
"9384",1828,1504,2380,56,44,100
"9385",1815,1500,2380,48,40,88
"9386",1438,1054,2386,54,44,98
"9387",2100,1732,2390,36,47,83
"9388",2125,1754,2390,57,69,126
"9389",2228,1903,2390,126,138,264
"9390",2055,1736,2390,33,51,84
"9391",2110,1718,2390,48,33,81
"9392",1737,1416,2393,67,76,143
"9393",1657,1326,2396,43,36,79
"9394",1247,926,2397,41,41,82
"9395",1425,1247,2399,215,217,432
"9396",1159,1026,2399,69,76,145
"9397",2030,1853,2400,40,43,83
"9398",1957,1830,2400,32,45,77
"9399",1815,1506,2405,56,56,112
"9400",1810,1458,2405,46,48,94
"9401",1806,1451,2405,42,41,83
"9402",1806,1457,2405,42,47,89
"9403",1859,1538,2405,93,88,181
"9404",1925,1608,2405,121,118,239
"9405",1857,1551,2405,99,96,195
"9406",1822,1520,2405,56,70,126
"9407",1336,1248,2407,37,43,80
"9408",1332,1240,2407,33,35,68
"9409",2102,2008,2418,41,48,89
"9410",2110,2022,2418,53,62,115
"9411",2011,1909,2425,53,64,117
"9412",2205,2047,2425,173,162,335
"9413",2046,1941,2425,88,96,184
"9414",1629,1501,2427,42,41,83
"9415",1631,1513,2427,44,53,97
"9416",1701,1516,2427,74,56,130
"9417",1625,1505,2427,38,45,83
"9418",1353,1229,2429,73,64,137
"9419",1648,1522,2429,245,237,482
"9420",1317,1158,2429,34,33,67
"9421",2347,2234,2430,218,224,442
"9422",1411,1239,2433,81,74,155
"9423",1430,1253,2433,100,88,188
"9424",1213,1044,2434,40,39,79
"9425",1223,1050,2434,53,45,98
"9426",1138,836,2435,46,46,92
"9427",1529,1154,2435,250,224,474
"9428",1744,1647,2442,65,67,132
"9429",1716,1627,2442,46,52,98
"9430",1725,1627,2442,46,47,93
"9431",1735,1640,2442,56,60,116
"9432",125,42,2450,96,102,198
"9433",35,2349,2450,39,44,83
"9434",1234,1110,2453,125,110,235
"9435",2139,2037,2456,65,77,142
"9436",1846,1536,2472,54,46,100
"9437",1922,1601,2472,99,86,185
"9438",1811,1617,2474,42,47,89
"9439",1910,1715,2474,99,105,204
"9440",1729,1524,2479,42,44,86
"9441",1738,1523,2479,51,43,94
"9442",1838,1638,2479,111,118,229
"9443",2110,2019,2481,46,54,100
"9444",2207,2114,2481,105,109,214
"9445",1323,1215,2482,84,95,179
"9446",2203,1830,2488,126,120,246
"9447",2218,1854,2488,143,144,287
"9448",2105,1727,2488,68,57,125
"9449",2115,1724,2488,82,49,131
"9450",2256,1912,2488,183,157,340
"9451",2136,1815,2488,99,105,204
"9452",2036,1627,2492,65,32,97
"9453",2012,1628,2492,37,33,70
"9454",2024,1649,2492,48,54,102
"9455",2037,1654,2492,61,59,120
"9456",2057,1701,2492,86,66,152
"9457",2354,2202,2493,61,47,108
"9458",22,2258,2493,89,103,192
"9459",2338,2202,2493,45,47,92
"9460",2345,2205,2493,52,50,102
"9461",2125,1822,2496,91,109,200
"9462",2032,1731,2496,42,58,100
"9463",2028,1719,2496,38,46,84
"9464",1914,1743,2497,100,110,210
"9465",1805,1628,2497,31,35,66
"9466",1847,1705,2497,73,72,145
"9467",1456,1329,2499,64,39,103
"9468",1454,1353,2499,62,63,125
"9469",1511,1410,2499,81,80,161
"9470",1300,1213,2501,31,33,64
"9471",1329,1207,2503,41,42,83
"9472",2322,2217,2515,60,57,117
"9473",2306,2205,2515,44,45,89
"9474",2314,2212,2515,52,52,104
"9475",2255,2155,2515,33,35,68
"9476",2351,2257,2515,89,97,186
"9477",1528,1211,2520,81,79,160
"9478",926,812,2525,57,57,114
"9479",1114,1000,2525,160,165,325
"9480",1524,1429,2559,285,289,574
"9481",1451,1139,2564,48,54,102
"9482",1448,1131,2564,45,46,91
"9483",1441,1138,2564,41,53,94
"9484",1710,1256,2568,151,131,282
"9485",1736,1416,2572,32,31,63
"9486",1028,830,2573,71,70,141
"9487",1007,817,2573,50,57,107
"9488",1044,859,2573,87,99,186
"9489",1002,802,2573,45,42,87
"9490",1620,1352,2576,253,207,460
"9491",1630,1529,2581,67,59,126
"9492",1603,1508,2581,40,38,78
"9493",1603,1505,2581,39,34,73
"9494",1654,1513,2589,45,33,78
"9495",1643,1514,2589,34,34,68
"9496",1720,1557,2592,71,70,141
"9497",1810,1633,2592,118,106,224
"9498",1723,1554,2592,60,56,116
"9499",1757,1439,2594,31,34,65
"9500",1916,1606,2594,130,141,271
"9501",39,2133,2597,89,103,192
"9502",36,2122,2597,86,92,178
"9503",27,2118,2597,77,88,165
"9504",2344,2032,2597,34,42,76
"9505",47,2138,2597,97,108,205
"9506",2345,2024,2597,35,34,69
"9507",14,2100,2597,64,70,134
"9508",2144,1953,2598,136,138,274
"9509",2026,1834,2598,56,59,115
"9510",2030,1839,2598,58,64,122
"9511",2044,1842,2598,72,67,139
"9512",1507,1347,2600,46,52,98
"9513",1621,1448,2600,117,108,225
"9514",929,748,2606,44,33,77
"9515",1240,930,2618,53,50,103
"9516",1717,1350,2618,330,310,640
"9517",1755,1640,2625,90,80,170
"9518",1814,1712,2625,109,112,221
"9519",1730,1627,2625,65,67,132
"9520",1755,1656,2625,90,96,186
"9521",1758,1657,2625,93,97,190
"9522",1713,1559,2625,48,34,82
"9523",1705,1607,2625,40,42,82
"9524",1709,1356,2629,41,41,82
"9525",1726,1423,2629,58,68,126
"9526",1554,1502,2631,32,37,69
"9527",2227,2037,2651,31,42,73
"9528",2144,2004,2651,37,44,81
"9529",2313,2108,2651,121,108,229
"9530",2238,2051,2651,40,56,96
"9531",2312,2121,2651,78,86,164
"9532",2314,2112,2651,78,77,155
"9533",2304,2152,2654,44,37,81
"9534",2322,2217,2654,62,62,124
"9535",2336,2235,2654,74,80,154
"9536",40,2359,2659,56,59,115
"9537",1931,1818,2675,57,48,105
"9538",1918,1802,2675,44,32,76
"9539",1044,954,2683,58,57,115
"9540",945,816,2687,45,46,91
"9541",6,2318,2692,110,118,228
"9542",2300,2207,2692,44,47,91
"9543",2300,2207,2692,46,47,93
"9544",2307,2210,2692,53,50,103
"9545",151,100,2692,217,220,437
"9546",2306,2214,2692,59,59,118
"9547",1843,1629,2695,71,34,105
"9548",1953,1814,2695,125,128,253
"9549",1848,1647,2695,61,42,103
"9550",1835,1647,2695,48,42,90
"9551",1839,1729,2705,54,61,115
"9552",1924,1814,2705,99,106,205
"9553",1838,1726,2705,53,58,111
"9554",1819,1659,2705,34,31,65
"9555",2242,2034,2712,95,94,189
"9556",1801,1453,2715,72,77,149
"9557",1751,1438,2715,58,63,121
"9558",1807,1436,2715,74,61,135
"9559",1739,1429,2715,46,54,100
"9560",1724,1411,2715,31,36,67
"9561",2159,1857,2728,137,132,269
"9562",2027,1720,2728,45,35,80
"9563",2022,1725,2728,40,45,85
"9564",2257,1935,2728,197,175,372
"9565",2046,1739,2728,64,59,123
"9566",2039,1732,2728,59,52,111
"9567",2125,2031,2731,88,91,179
"9568",2123,2032,2731,91,92,183
"9569",2052,2000,2731,55,60,115
"9570",2045,1950,2731,48,50,98
"9571",2053,2007,2731,56,67,123
"9572",2052,1956,2731,55,56,111
"9573",1239,1109,2734,73,64,137
"9574",1430,1125,2736,78,70,148
"9575",1452,1143,2736,74,63,137
"9576",1938,1807,2748,80,62,142
"9577",1904,1736,2748,56,46,102
"9578",1848,1724,2748,40,34,74
"9579",1914,1757,2748,60,65,125
"9580",1858,1736,2748,44,44,88
"9581",1947,1824,2748,93,92,185
"9582",1917,1755,2748,63,63,126
"9583",1254,1052,2750,47,32,79
"9584",1651,1555,2755,50,42,92
"9585",2016,1830,2759,37,35,72
"9586",2111,1924,2759,88,89,177
"9587",2044,1901,2759,61,66,127
"9588",2009,1833,2759,42,43,85
"9589",2059,1912,2759,92,82,174
"9590",2016,1846,2759,49,56,105
"9591",2047,1909,2759,80,79,159
"9592",2027,1846,2759,48,51,99
"9593",2116,1926,2759,97,91,188
"9594",1527,1444,2769,60,64,124
"9595",1631,1543,2769,124,123,247
"9596",1517,1435,2769,50,55,105
"9597",1630,1537,2769,123,117,240
"9598",2113,2013,2776,48,48,96
"9599",2112,2014,2776,47,49,96
"9600",1751,1640,2778,86,95,181
"9601",1726,1556,2778,61,51,112
"9602",1835,1701,2778,130,116,246
"9603",1757,1644,2778,92,99,191
"9604",1853,1657,2778,148,112,260
"9605",1745,1618,2778,80,73,153
"9606",1804,1630,2778,99,85,184
"9607",2331,2028,2782,76,73,149
"9608",2332,2035,2782,34,45,79
"9609",30,2132,2782,92,102,194
"9610",2331,2036,2782,33,46,79
"9611",15,2102,2782,77,72,149
"9612",2332,2036,2782,34,46,80
"9613",2332,2032,2782,34,42,76
"9614",2356,2055,2782,56,65,121
"9615",2331,2119,2786,88,89,177
"9616",2307,2058,2786,64,68,132
"9617",28,2201,2786,145,131,276
"9618",127,2306,2786,204,196,400
"9619",50,2232,2786,167,162,329
"9620",1947,1856,2790,78,81,159
"9621",1927,1819,2790,58,44,102
"9622",1144,1025,2792,94,95,189
"9623",1108,935,2792,58,45,103
"9624",1056,931,2792,49,41,90
"9625",1601,1410,2794,36,35,71
"9626",1649,1502,2794,84,87,171
"9627",1837,1613,2798,68,38,106
"9628",1139,1007,2799,44,52,96
"9629",2202,2032,2800,53,57,110
"9630",2141,2024,2800,32,49,81
"9631",111,2359,2800,242,264,506
"9632",2325,2202,2800,136,147,283
"9633",2154,2031,2800,45,56,101
"9634",2158,2034,2800,49,59,108
"9635",2120,1720,2801,98,85,183
"9636",2240,2144,2803,45,39,84
"9637",2238,2144,2803,39,39,78
"9638",2310,2223,2803,71,78,149
"9639",2240,2152,2803,41,47,88
"9640",2142,2011,2804,48,51,99
"9641",2132,2009,2804,40,49,89
"9642",2155,1958,2804,73,43,116
"9643",1706,1619,2809,42,49,91
"9644",1750,1650,2809,65,65,130
"9645",1805,1712,2809,80,87,167
"9646",1726,1628,2809,41,43,84
"9647",1623,1444,2811,133,114,247
"9648",1312,1214,2817,43,49,92
"9649",1307,1207,2817,38,42,80
"9650",18,2109,2822,45,51,96
"9651",19,2101,2822,49,46,95
"9652",42,2115,2822,72,60,132
"9653",10,2050,2822,40,35,75
"9654",2349,2024,2822,51,34,85
"9655",8,2058,2822,38,43,81
"9656",1349,1235,2826,87,73,160
"9657",1346,1253,2826,84,91,175
"9658",2029,1839,2831,33,49,82
"9659",1624,1351,2832,77,51,128
"9660",1607,1415,2832,60,75,135
"9661",1820,1714,2834,34,44,78
"9662",1843,1736,2834,62,66,128
"9663",1953,1838,2834,127,128,255
"9664",1835,1726,2834,49,56,105
"9665",1613,1351,2837,191,166,357
"9666",1931,1803,2840,90,88,178
"9667",1927,1755,2840,81,80,161
"9668",1732,1415,2841,34,40,74
"9669",1929,1538,2841,151,123,274
"9670",1849,1503,2841,111,88,199
"9671",1804,1433,2841,66,58,124
"9672",1815,1447,2841,77,72,149
"9673",1519,1344,2844,40,44,84
"9674",1633,1458,2844,111,118,229
"9675",1555,1404,2844,87,69,156
"9676",1258,1238,2847,41,43,84
"9677",1251,1228,2847,34,33,67
"9678",1313,1238,2847,56,53,109
"9679",2307,1952,2862,39,42,81
"9680",2251,1949,2862,31,39,70
"9681",2317,2007,2862,50,57,107
"9682",34,2112,2862,126,122,248
"9683",2317,2143,2873,164,183,347
"9684",2239,2100,2873,151,165,316
"9685",2051,1910,2873,45,55,100
"9686",2056,1909,2873,63,64,127
"9687",1625,1420,2881,111,98,209
"9688",1539,1349,2881,65,67,132
"9689",2337,2134,2882,251,244,495
"9690",2202,2014,2882,158,164,322
"9691",2015,1829,2882,51,59,110
"9692",1959,1805,2882,33,35,68
"9693",1839,1520,2885,49,65,114
"9694",1944,1558,2885,114,103,217
"9695",1428,1331,2887,83,86,169
"9696",1445,1318,2887,100,73,173
"9697",1753,1404,2889,33,39,72
"9698",1801,1414,2889,46,49,95
"9699",903,756,2891,31,41,72
"9700",1203,1019,2891,216,184,400
"9701",959,850,2891,87,95,182
"9702",1057,950,2891,145,155,300
"9703",1637,1354,2892,36,34,70
"9704",1722,1438,2892,81,78,159
"9705",1638,1355,2892,37,35,72
"9706",1634,1351,2892,33,31,64
"9707",1710,1435,2892,60,64,124
"9708",1526,1413,2895,161,145,306
"9709",2125,2008,2899,56,48,104
"9710",2230,2058,2899,121,98,219
"9711",1218,1111,2901,113,116,229
"9712",2018,1917,2902,91,82,173
"9713",1918,1824,2902,44,44,88
"9714",2131,2039,2907,63,69,132
"9715",2150,2100,2907,85,95,180
"9716",2058,1959,2907,33,34,67
"9717",2159,2108,2907,94,103,197
"9718",2221,2133,2907,116,128,244
"9719",1149,1012,2908,82,77,159
"9720",1256,1055,2916,106,115,221
"9721",1158,950,2916,48,50,98
"9722",1155,933,2916,45,33,78
"9723",1843,1658,2917,50,63,113
"9724",1903,1748,2920,44,56,100
"9725",1925,1753,2920,64,59,123
"9726",1918,1758,2920,59,66,125
"9727",1855,1728,2920,36,36,72
"9728",1852,1724,2920,62,54,116
"9729",1930,1803,2920,71,71,142
"9730",1214,1026,2922,57,66,123
"9731",1214,1015,2922,57,55,112
"9732",1248,1130,2928,59,65,124
"9733",1243,1121,2928,56,56,112
"9734",1849,1534,2930,109,109,218
"9735",1822,1458,2930,82,73,155
"9736",1816,1506,2930,76,81,157
"9737",1915,1825,2936,138,145,283
"9738",1729,1639,2936,32,39,71
"9739",1740,1645,2936,43,45,88
"9740",1732,1636,2936,35,36,71
"9741",1749,1657,2936,62,67,129
"9742",2301,2124,2938,54,69,123
"9743",2328,2147,2938,81,92,173
"9744",2249,2055,2938,42,40,82
"9745",2345,2205,2938,98,110,208
"9746",2251,2111,2938,44,56,100
"9747",38,2206,2938,151,111,262
"9748",2334,2153,2938,87,98,185
"9749",2354,2212,2938,107,117,224
"9750",2255,2046,2938,66,31,97
"9751",2231,2050,2938,42,35,77
"9752",2243,2056,2938,36,41,77
"9753",1347,1244,2941,67,74,141
"9754",1849,1714,2944,56,54,110
"9755",1833,1705,2944,54,65,119
"9756",1829,1643,2944,49,43,92
"9757",1632,1455,2945,38,40,78
"9758",1640,1503,2945,47,48,95
"9759",1640,1507,2945,47,52,99
"9760",1638,1502,2945,42,47,89
"9761",1636,1449,2945,40,34,74
"9762",1925,1654,2948,40,39,79
"9763",2222,1924,2948,228,209,437
"9764",1922,1656,2948,48,61,109
"9765",2011,1748,2948,97,113,210
"9766",2153,2032,2954,62,67,129
"9767",2203,2046,2954,74,81,155
"9768",2123,2010,2954,34,45,79
"9769",2201,2027,2954,70,62,132
"9770",2235,2118,2954,106,113,219
"9771",1312,1143,2967,163,158,321
"9772",2358,2215,2974,106,115,221
"9773",2038,1837,2974,51,52,103
"9774",2351,2159,2976,46,49,95
"9775",2351,2146,2976,52,36,88
"9776",12,2222,2976,67,72,139
"9777",121,2340,2976,136,150,286
"9778",155,11,2976,170,181,351
"9779",1640,1329,2980,43,39,82
"9780",1714,1406,2980,54,46,100
"9781",1722,1408,2980,83,78,161
"9782",1151,1042,2996,32,37,69
"9783",1207,1047,2996,43,42,85
"9784",1520,1358,2998,61,68,129
"9785",1539,1326,2998,80,36,116
"9786",1457,1335,2998,38,45,83
"9787",1533,1358,2998,74,68,142
"9788",1255,1103,3002,56,53,109
"9789",1709,1421,3004,86,71,157
"9790",1648,1407,3004,64,57,121
"9791",1648,1421,3004,64,71,135
"9792",1905,1814,3005,33,39,72
"9793",1924,1828,3005,52,53,105
"9794",1933,1834,3005,61,59,120
"9795",1456,1056,3008,42,46,88
"9796",11,2108,3010,38,38,76
"9797",2214,2039,3016,48,54,102
"9798",2205,2036,3016,38,51,89
"9799",2206,2029,3016,39,44,83
"9800",2257,2125,3016,92,100,192
"9801",2255,2121,3016,90,96,186
"9802",2207,2034,3016,40,49,89
"9803",2226,2052,3016,64,67,131
"9804",2245,2103,3016,79,78,157
"9805",2154,2040,3022,69,70,139
"9806",2134,2020,3022,49,50,99
"9807",2210,2059,3022,46,54,100
"9808",2154,2042,3022,32,37,69
"9809",2243,2134,3022,79,89,168
"9810",2226,2111,3022,62,66,128
"9811",2004,1909,3027,41,49,90
"9812",1958,1854,3027,34,34,68
"9813",2012,1912,3027,48,52,100
"9814",1957,1859,3027,33,39,72
"9815",1128,811,3032,40,51,91
"9816",1655,1527,3033,63,67,130
"9817",1738,1547,3033,106,87,193
"9818",1415,1106,3035,45,46,91
"9819",7,2048,3036,58,48,106
"9820",13,2102,3036,33,42,75
"9821",28,2112,3036,53,52,105
"9822",57,2145,3036,77,85,162
"9823",30,2117,3036,50,57,107
"9824",11,2052,3036,31,32,63
"9825",2242,2046,3038,64,61,125
"9826",2252,2101,3038,74,76,150
"9827",2227,2027,3038,38,37,75
"9828",2255,2105,3038,66,75,141
"9829",2221,2037,3038,32,47,79
"9830",2331,2132,3038,102,102,204
"9831",2244,2055,3038,55,65,120
"9832",2307,2117,3038,78,87,165
"9833",2232,2045,3038,43,55,98
"9834",2225,2031,3038,36,41,77
"9835",2222,2024,3038,33,34,67
"9836",929,751,3040,32,31,63
"9837",1,2052,3050,93,87,180
"9838",16,2100,3050,108,95,203
"9839",2259,1955,3050,36,40,76
"9840",57,2139,3050,154,144,298
"9841",2330,2025,3050,70,70,140
"9842",1038,908,3059,104,98,202
"9843",1214,1052,3060,45,42,87
"9844",1216,1100,3060,49,50,99
"9845",1130,1028,3068,48,53,101
"9846",1828,1431,3078,52,37,89
"9847",1839,1431,3078,63,37,100
"9848",1819,1438,3078,32,41,73
"9849",1834,1442,3078,47,45,92
"9850",1919,1523,3078,92,86,178
"9851",1818,1440,3078,31,43,74
"9852",1119,852,3083,55,67,122
"9853",1529,1333,3092,76,73,149
"9854",1534,1347,3092,81,87,168
"9855",1452,1256,3092,60,54,114
"9856",1508,1241,3092,76,46,122
"9857",1129,812,3096,35,42,77
"9858",2015,1627,3098,57,46,103
"9859",2031,1913,3101,44,48,92
"9860",2106,1946,3101,79,81,160
"9861",1241,1125,3119,56,60,116
"9862",1213,811,3120,86,41,127
"9863",1432,1324,3120,34,35,69
"9864",2108,1945,3127,67,80,147
"9865",2128,2002,3127,87,97,184
"9866",2043,1906,3127,42,41,83
"9867",2130,2002,3127,94,97,191
"9868",2137,2015,3127,100,105,205
"9869",2400,2051,3137,67,66,133
"9870",2327,2020,3137,32,35,67
"9871",20,2126,3137,85,101,186
"9872",224,2337,3137,209,232,441
"9873",2353,2047,3137,58,62,120
"9874",1332,1200,3152,33,35,68
"9875",1659,1508,3152,240,223,463
"9876",2254,2056,3154,31,40,71
"9877",2346,2156,3154,83,100,183
"9878",31,2228,3154,128,132,260
"9879",2048,1931,3155,81,71,152
"9880",1447,1335,1123,63,60,123
"9881",1736,1659,1156,36,44,80
"9882",1757,1732,1156,54,57,111
"9883",1115,1015,1168,73,75,148
"9884",1248,1124,1171,78,104,182
"9885",1251,901,1178,101,96,197
"9886",2203,1943,1179,31,48,79
"9887",2232,2013,1179,60,78,138
"9888",2220,1955,1179,48,60,108
"9889",2224,2000,1179,52,65,117
"9890",1113,948,1180,48,43,91
"9891",1641,1437,1183,94,97,191
"9892",1633,1352,1183,86,52,138
"9893",928,851,1184,81,76,157
"9894",913,836,1184,61,61,122
"9895",1940,1858,1185,38,48,86
"9896",1956,1909,1185,54,59,113
"9897",2134,2050,1185,152,160,312
"9898",2039,1950,1185,101,105,206
"9899",1936,1842,1185,38,37,75
"9900",1610,1414,1187,133,137,270
"9901",1456,1258,1187,54,61,115
"9902",1849,1546,1190,161,161,322
"9903",1428,1224,1190,55,59,114
"9904",1419,1157,1190,46,32,78
"9905",1412,1211,1191,32,31,63
"9906",1546,1313,1191,126,93,219
"9907",1445,1254,1191,65,74,139
"9908",1456,1244,1191,76,64,140
"9909",2202,1813,1192,73,74,147
"9910",2134,1754,1192,45,55,100
"9911",1846,1830,1193,47,60,107
"9912",1922,1901,1193,83,86,169
"9913",1901,1846,1193,62,71,133
"9914",1918,1906,1193,79,91,170
"9915",1847,1818,1193,48,43,91
"9916",1911,1845,1193,72,75,147
"9917",1831,1807,1193,32,32,64
"9918",1656,1339,1197,39,54,93
"9919",1245,1208,1198,35,33,68
"9920",28,2341,1199,45,41,86
"9921",1537,1150,1164,105,100,205
"9922",1427,1056,1164,40,46,86
"9923",1709,1404,5841,161,159,320
"9924",1404,1245,1113,96,70,166
"9925",1600,1239,1163,106,109,215
"9926",1444,1049,1164,52,39,91
"9927",1348,1155,5845,80,80,160
"9928",1510,1312,5845,162,157,319
"9929",1344,1148,5845,81,73,154
"9930",1221,1134,1111,53,54,107
"9931",1027,814,4484,77,74,151
"9932",1009,803,4484,59,63,122
"9933",1758,1358,1154,48,33,81
"9934",1908,1730,5825,61,45,106
"9935",1939,1806,5825,92,81,173
"9936",1918,1758,5825,71,73,144
"9937",1152,1058,5819,200,203,403
"9938",1424,1108,5820,46,33,79
"9939",2258,2046,5821,41,36,77
"9940",2311,2101,5821,54,51,105
"9941",2337,2116,5821,80,66,146
"9942",2307,2052,5821,50,42,92
"9943",2317,2101,5821,60,51,111
"9944",2339,2135,5821,82,85,167
"9945",2304,2043,5821,47,33,80
"9946",2258,2057,5821,41,47,88
"9947",2336,2127,5821,79,77,156
"9948",14,2155,5821,117,105,222
"9949",2333,2102,5821,76,52,128
"9950",1544,1233,5822,79,68,147
"9951",1544,1234,5822,74,69,143
"9952",1751,1645,5822,86,92,178
"9953",1732,1553,5822,70,43,113
"9954",1709,1548,5822,47,38,85
"9955",1734,1608,5822,72,58,130
"9956",2152,2030,5823,180,170,350
"9957",2057,1951,5823,125,131,256
"9958",2014,1859,5823,82,79,161
"9959",1941,1824,5823,49,44,93
"9960",2105,1941,5823,133,121,254
"9961",2129,2006,5823,157,146,303
"9962",1956,1846,5823,64,66,130
"9963",1956,1844,5823,69,64,133
"9964",2028,1917,5823,96,97,193
"9965",2316,2152,5824,42,37,79
"9966",6,2242,5824,92,87,179
"9967",2325,2209,5824,51,54,105
"9968",1757,1721,1156,57,66,123
"9969",1228,1158,1142,168,153,321
"9970",1029,1009,1142,44,44,88
"9971",1436,1158,1145,33,33,66
"9972",1656,1515,1147,55,63,118
"9973",1649,1543,1122,179,173,352
"9974",1518,1403,1123,94,88,182
"9975",1430,1310,1123,46,35,81
"9976",1654,1524,1130,52,34,86
"9977",1701,1522,1130,54,32,86
"9978",1736,1541,1136,79,76,155
"9979",2001,1800,1136,144,150,294
"9980",2053,1845,1139,46,45,91
"9981",2153,1904,1139,106,64,170
"9982",2044,1841,1139,37,41,78
"9983",2048,1839,1139,41,39,80
"9984",2046,1845,1139,39,45,84
"9985",2101,1854,1139,54,54,108
"9986",1237,1123,1142,132,138,270
"9987",1028,1009,1142,43,44,87
"9988",1312,1237,1142,207,192,399
"9989",1019,712,5619,107,72,179
"9990",2026,1923,1102,114,113,227
"9991",1942,1837,1102,65,67,132
"9992",1500,1329,1103,65,39,104
"9993",2157,2031,1155,65,61,126
"9994",2205,2050,1155,73,80,153
"9995",2206,2031,1155,89,76,165
"9996",2157,2045,1155,80,90,170
"9997",1642,1348,4492,38,37,75
"9998",2148,2052,1102,191,202,393
"9999",1915,1807,1102,43,37,80
"10000",1926,1818,1102,56,48,104
"10001",1545,1414,1123,121,99,220
"10002",19,2310,1126,134,140,274
"10003",2314,2203,1126,69,73,142
"10004",1618,1520,1152,41,45,86
"10005",1643,1537,1152,66,62,128
"10006",1523,1206,5841,58,41,99
"10007",1137,839,5842,70,74,144
"10008",2020,1856,5842,50,41,91
"10009",2222,2114,5842,172,179,351
"10010",2100,1945,5842,90,90,180
"10011",2014,1857,5842,44,42,86
"10012",2016,1905,5842,46,50,96
"10013",1856,1729,5843,67,62,129
"10014",1838,1722,5843,49,55,104
"10015",1859,1729,5843,70,62,132
"10016",1835,1704,5843,46,37,83
"10017",1830,1712,5843,41,45,86
"10018",1855,1740,5843,66,73,139
"10019",1921,1759,5843,92,92,184
"10020",1820,1703,5843,31,36,67
"10021",1844,1721,5843,55,54,109
"10022",2028,1503,1150,166,48,214
"10023",1852,1536,1150,70,81,151
"10024",1952,1613,1150,130,118,248
"10025",1922,1613,1150,100,118,218
"10026",1910,1532,1150,88,77,165
"10027",1845,1508,1150,63,53,116
"10028",2204,2149,1108,53,56,109
"10029",2201,2136,1108,50,43,93
"10030",2212,2203,1108,61,70,131
"10031",2247,2230,1108,97,100,197
"10032",2204,2141,1108,53,48,101
"10033",2157,2125,1108,46,32,78
"10034",1705,1500,4455,45,40,85
"10035",1822,1450,1114,42,65,107
"10036",2301,1946,1117,39,41,80
"10037",2355,2022,1117,75,62,137
"10038",13,2102,1117,93,102,195
"10039",8,2059,1117,88,99,187
"10040",1944,1627,1130,72,42,114
"10041",1918,1637,1130,46,52,98
"10042",1910,1643,1130,38,58,96
"10043",1935,1657,1130,63,72,135
"10044",1914,1623,1130,42,38,80
"10045",1927,1659,5827,35,39,74
"10046",1933,1708,5827,41,48,89
"10047",1947,1706,5827,55,46,101
"10048",1320,1016,5828,62,66,128
"10049",1732,1613,5830,94,93,187
"10050",1701,1528,5830,63,48,111
"10051",1753,1601,5830,115,81,196
"10052",34,2136,5834,52,46,98
"10053",1932,1727,5814,115,107,222
"10054",1644,1548,5815,35,42,77
"10055",1457,1128,5817,45,48,93
"10056",1129,826,5565,177,146,323
"10057",1128,849,5657,176,169,345
"10058",2325,2224,5800,77,89,166
"10059",2321,2225,5800,73,90,163
"10060",954,832,5800,57,57,114
"10061",928,823,5801,66,53,119
"10062",1558,1251,5801,117,119,236
"10063",2250,2123,5801,168,163,331
"10064",2118,1951,5801,76,71,147
"10065",2319,2201,5805,32,36,68
"10066",1850,1727,5807,180,177,357
"10067",1328,1026,5808,61,67,128
"10068",1303,957,5808,36,38,74
"10069",1329,1016,5808,62,57,119
"10070",1305,1003,5808,38,44,82
"10071",1304,1005,5808,37,46,83
"10072",1352,1013,5808,85,54,139
"10073",1512,1159,5809,115,109,224
"10074",1713,1420,5810,39,50,89
"10075",1907,1644,5812,77,54,131
"10076",1841,1641,5812,56,56,112
"10077",1934,1727,5812,109,102,211
"10078",1826,1622,5812,36,32,68
"10079",1838,1603,222,36,33,69
"10080",2050,1827,230,50,57,107
"10081",2054,1828,230,54,58,112
"10082",2115,1856,230,75,86,161
"10083",20,2148,230,260,258,518
"10084",1700,1538,284,171,170,341
"10085",1445,1329,284,36,41,77
"10086",1452,1334,308,43,46,89
"10087",1617,1452,367,125,125,250
"10088",854,652,415,86,52,138
"10089",2032,1816,420,150,166,316
"10090",1218,950,434,140,109,249
"10091",1136,923,434,98,82,180
"10092",1139,955,434,101,114,215
"10093",1910,1616,515,68,46,114
"10094",1444,1325,550,32,32,64
"10095",1847,1603,575,45,33,78
"10096",2013,1750,575,131,140,271
"10097",1341,1108,612,139,138,277
"10098",2253,2030,656,293,300,593
"10099",1921,1522,756,74,76,150
"10100",1946,1546,756,99,100,199
"10101",1839,1448,756,32,42,74
"10102",1907,1506,756,60,60,120
"10103",2039,1655,756,152,169,321
"10104",52,2344,771,147,169,316
"10105",2339,2235,771,74,100,174
"10106",2346,2223,771,81,88,169
"10107",2320,2143,771,55,48,103
"10108",1545,1412,801,96,84,180
"10109",1521,1359,801,72,71,143
"10110",1832,1403,816,166,138,304
"10111",1253,1041,855,98,103,201
"10112",1426,1235,855,203,210,413
"10113",124,2334,855,861,869,1730
"10114",2019,1828,855,556,563,1119
"10115",1157,955,855,54,50,104
"10116",816,704,869,48,64,112
"10117",1731,1500,910,47,46,93
"10118",1655,1536,984,166,168,334
"10119",1517,1404,984,68,76,144
"10120",2033,1932,528,96,82,178
"10121",2303,1915,959,119,100,219
"10122",1417,1044,1170,35,32,67
"10123",1214,835,1696,93,85,178
"10124",2034,1634,1978,96,69,165
"10125",2025,1650,1978,87,85,172
"10126",2350,2317,278,121,127,248
"10127",1941,1850,528,44,40,84
"10128",1325,915,1696,164,125,289
"10129",2218,1845,959,74,70,144
"10130",1611,1245,1122,43,45,88
"10131",1331,1000,1696,170,170,340
"10132",1650,1545,269,66,40,106
"10133",924,609,996,43,58,101
"10134",2147,1822,1978,169,177,346
"10135",1855,1524,1122,207,204,411
"10136",1418,1043,1170,36,31,67
"10137",2219,1834,959,75,59,134
"10138",1718,1308,1122,110,68,178
"10139",1509,1142,1170,87,90,177
"10140",2112,1739,1978,134,134,268
"10141",1531,1207,1170,109,115,224
"10142",1228,906,1696,107,116,223
"10143",1310,940,1696,149,150,299
"10144",2341,1944,45,36,44,80
"10145",1735,1335,756,60,65,125
"10146",2253,2205,60,58,65,123
"10147",1517,1433,300,37,48,85
"10148",1142,1035,7,37,40,77
"10149",2251,2146,234,51,56,107
"10150",33,2118,51,43,38,81
"10151",1221,859,2202,81,74,155
"10152",2324,2109,1767,34,39,73
"10153",903,756,2622,103,96,199
"10154",2159,2042,117,34,37,71
"10155",17,2117,1271,37,37,74
"10156",1327,1209,679,52,54,106
"10157",2357,1957,45,52,57,109
"10158",1430,1337,20,155,157,312
"10159",1348,1256,24,53,56,109
"10160",1936,1846,48,36,46,82
"10161",2251,2200,55,31,35,66
"10162",1702,1543,1420,62,83,145
"10163",1312,1201,741,82,86,168
"10164",30,2118,51,40,38,78
"10165",36,2029,37,191,204,395
"10166",2006,1815,395,41,40,81
"10167",18,2118,1271,38,38,76
"10168",2222,1826,934,32,41,73
"10169",2246,2205,325,81,90,171
"10170",1745,1645,36,110,105,215
"10171",1645,1548,1675,40,58,98
"10172",1758,1541,565,73,81,154
"10173",1514,1415,1576,124,125,249
"10174",1932,1630,33,37,35,72
"10175",1905,1721,1683,110,116,226
"10176",2125,2014,1039,35,34,69
"10177",1904,1808,61,34,38,72
"10178",1750,1709,1257,45,49,94
"10179",2253,2120,1405,43,45,88
"10180",1936,1751,254,31,41,72
"10181",2252,2207,3214,42,47,89
"10182",2241,2149,58,76,79,155
"10183",1957,1904,39,92,94,186
"10184",2025,1909,41,70,64,134
"10185",2342,2039,37,212,214,426
"10186",2331,2215,1374,51,55,106
"10187",39,2050,49,44,55,99
"10188",1712,1622,38,42,52,94
"10189",1347,1216,15,32,41,73
"10190",1856,1642,33,76,42,118
"10191",2223,2119,230,33,44,77
"10192",1953,1840,512,58,50,108
"10193",1842,1659,763,122,89,211
"10194",2356,2233,794,36,38,74
"10195",1438,1129,7,78,94,172
"10196",121,2218,51,91,103,194
"10197",11,2105,291,71,80,151
"10198",2211,2012,164,41,32,73
"10199",1907,1757,125,32,37,69
"10200",1806,1652,715,61,62,123
"10201",1921,1835,3574,41,45,86
"10202",2201,1854,8,174,184,358
"10203",5,2107,54,165,176,341
"10204",1410,1106,1590,118,119,237
"10205",2015,1628,8,68,38,106
"10206",1158,858,1884,173,183,356
"10207",2000,1633,8,53,43,96
"10208",2015,1648,8,68,58,126
"10209",2121,1819,8,134,149,283
"10210",1928,1523,1409,57,43,100
"10211",1428,1113,1590,136,126,262
"10212",2007,1711,8,60,81,141
"10213",129,2241,54,249,270,519
"10214",1723,1418,1675,44,48,92
"10215",11,2050,54,171,159,330
"10216",1044,735,810,34,35,69
"10217",2302,1939,54,102,88,190
"10218",2000,1705,8,53,75,128
"10219",2151,1850,54,31,39,70
"10220",1950,1637,8,43,47,90
"10221",2157,1853,54,37,42,79
"10222",1922,1545,1409,51,65,116
"10223",2015,1700,8,68,70,138
"10224",2253,1955,8,226,245,471
"10225",2302,1900,4989,112,104,216
"10226",2204,1831,4989,54,75,129
"10227",2232,1831,4989,82,75,157
"10228",2329,2009,4989,139,173,312
"10229",2244,1853,4989,94,97,191
"10230",1254,955,4996,230,235,465
"10231",1531,1202,5049,94,76,170
"10232",1527,1206,5049,90,80,170
"10233",1554,1242,5049,117,116,233
"10234",1434,1144,5049,37,58,95
"10235",2155,1908,5183,46,63,109
"10236",2152,1903,5183,43,58,101
"10237",1948,1647,5190,48,47,95
"10238",1957,1650,5190,57,50,107
"10239",1240,942,5225,42,36,78
"10240",1000,643,5344,51,43,94
"10241",1844,1721,5393,44,61,105
"10242",2019,1853,5393,139,153,292
"10243",2232,2057,5393,272,277,549
"10244",1839,1718,5393,39,58,97
"10245",1715,1525,5402,239,225,464
"10246",1354,1216,5402,38,36,74
"10247",1046,739,5438,41,39,80
"10248",1043,750,5445,41,50,91
"10249",1436,1204,5453,65,79,144
"10250",1453,1218,5453,82,93,175
"10251",1457,1233,5453,86,108,194
"10252",2120,1844,5453,469,479,948
"10253",1416,1256,777,51,51,102
"10254",2119,2000,563,49,50,99
"10255",1432,1308,777,67,63,130
"10256",1438,1317,777,73,72,145
"10257",2113,1944,563,43,34,77
"10258",1429,1247,777,64,42,106
"10259",2103,1945,147,33,35,68
"10260",2117,1958,147,47,48,95
"10261",2121,2016,147,51,66,117
"10262",1243,931,290,193,176,369
"10263",52,2207,292,259,269,528
"10264",2204,1856,292,86,81,167
"10265",2259,2006,296,39,46,85
"10266",1750,1451,288,31,31,62
"10267",1743,1446,288,35,37,72
"10268",2115,1810,292,37,35,72
"10269",2301,1904,292,143,89,232
"10270",2341,2047,296,81,87,168
"10271",1856,1548,288,97,88,185
"10272",2200,1911,292,82,96,178
"10273",2300,1953,296,40,33,73
"10274",2345,2053,292,187,198,385
"10275",4,2104,296,104,104,208
"10276",1227,941,290,174,191,365
"10277",2222,1919,292,104,104,208
"10278",1814,1509,288,55,49,104
"10279",2023,1905,2870,43,40,83
"10280",2013,1914,2870,33,49,82
"10281",2012,1905,2870,32,35,67
"10282",2035,1932,2870,55,62,117
"10283",2058,1942,2870,78,72,150
"10284",2109,2012,2870,89,102,191
"10285",1237,1137,2958,72,77,149
"10286",1332,1226,3210,222,226,448
"10287",1031,913,3210,41,33,74
"10288",1123,1023,3210,93,103,196
"10289",1357,1254,3216,57,64,121
"10290",1349,1239,3216,49,49,98
"10291",1410,1307,3216,70,77,147
"10292",1230,1123,3265,325,323,648
"10293",2220,2121,3328,95,106,201
"10294",2155,2057,3328,70,82,152
"10295",2141,2039,3328,56,64,120
"10296",2152,2047,3328,67,72,139
"10297",2123,2016,3328,38,41,79
"10298",1704,1602,3390,54,67,121
"10299",1644,1540,3390,34,45,79
"10300",2300,2047,3717,60,87,147
"10301",2258,2020,3717,58,60,118
"10302",2246,2031,3717,46,71,117
"10303",1457,1339,3719,32,49,81
"10304",1606,1429,3719,136,119,255
"10305",1456,1316,3719,66,46,112
"10306",1508,1400,3719,78,90,168
"10307",1424,1316,3719,34,46,80
"10308",2239,2108,3724,54,43,97
"10309",2342,2232,3724,117,127,244
"10310",2236,2112,3724,51,47,98
"10311",2221,2057,3724,36,32,68
"10312",2239,2113,3724,54,48,102
"10313",2222,2102,3724,37,37,74
"10314",2227,2106,3724,42,41,83
"10315",2246,2139,3724,61,74,135
"10316",1529,1403,3762,364,378,742
"10317",1016,850,3762,41,35,76
"10318",1007,849,3762,32,34,66
"10319",1936,1651,3786,66,61,127
"10320",1855,1634,3786,40,54,94
"10321",2020,1752,3786,125,132,257
"10322",1903,1639,3786,48,59,107
"10323",1926,1654,3786,71,74,145
"10324",1857,1619,3786,42,39,81
"10325",1908,1650,3786,53,70,123
"10326",1851,1640,3786,36,60,96
"10327",1944,1624,3786,89,44,133
"10328",2011,1734,3786,116,114,230
"10329",1902,1650,3786,47,70,117
"10330",1916,1614,3786,61,34,95
"10331",1800,1521,3796,245,246,491
"10332",1439,1159,3796,44,44,88
"10333",1436,1208,3796,41,53,94
"10334",1105,752,3859,115,72,187
"10335",1121,859,3859,131,139,270
"10336",2243,2029,3859,793,814,1607
"10337",1137,839,3859,127,104,231
"10338",1039,809,3859,69,74,143
"10339",1728,1415,3859,478,440,918
"10340",1847,1746,322,42,66,108
"10341",2232,2137,426,67,92,159
"10342",2205,2104,426,40,59,99
"10343",2203,2048,426,38,43,81
"10344",2224,1900,1294,39,55,94
"10345",2312,1846,1294,87,41,128
"10346",2315,1956,1294,90,111,201
"10347",2246,1915,1294,61,70,131
"10348",924,826,1393,34,46,80
"10349",1348,1248,1534,53,63,116
"10350",1614,1509,1632,34,44,78
"10351",1651,1549,1632,71,84,155
"10352",1120,1015,1995,50,60,110
"10353",1247,1139,1995,137,144,281
"10354",1910,1750,2406,65,70,135
"10355",1928,1823,2406,83,103,186
"10356",2307,2058,731,123,138,261
"10357",2139,1911,731,35,31,66
"10358",2200,1951,731,58,71,129
"10359",2205,1720,622,125,125,250
"10360",2106,1640,622,66,85,151
"10361",2044,1555,622,44,40,84
"10362",1503,1046,620,243,256,499
"10363",2120,1644,622,80,89,169
"10364",2307,1759,622,187,164,351
"10365",1232,800,620,92,90,182
"10366",2237,1737,622,157,142,299
"10367",2228,2039,47,107,89,196
"10368",1956,1513,62,32,38,70
"10369",2352,2025,1042,35,45,80
"10370",1726,1327,1087,36,32,68
"10371",1439,1118,1438,44,53,97
"10372",1810,1552,1485,79,87,166
"10373",2357,2242,1525,90,107,197
"10374",1437,1346,1572,50,56,106
"10375",2150,1727,1594,65,96,161
"10376",2359,2057,1602,72,82,154
"10377",1239,1103,1701,61,68,129
"10378",1545,1410,1750,43,70,113
"10379",2012,1612,1755,54,57,111
"10380",1534,1410,1785,37,40,77
"10381",119,2214,1787,47,39,86
"10382",1025,902,1791,33,32,65
"10383",1656,1131,1819,91,51,142
"10384",2044,1841,863,54,71,125
"10385",1235,941,1421,32,41,73
"10386",2335,2238,1423,79,88,167
"10387",2126,2044,1441,69,74,143
"10388",2358,2106,1498,113,131,244
"10389",1516,1106,1527,41,41,82
"10390",2347,2303,1533,108,113,221
"10391",14,2012,1595,71,67,138
"10392",18,2241,1644,80,91,171
"10393",2212,2037,1724,144,167,311
"10394",2000,1547,1755,42,32,74
"10395",1938,1511,1811,113,121,234
"10396",1151,825,1849,59,60,119
"10397",236,2315,1853,174,210,384
"10398",2219,2045,47,98,95,193
"10399",2136,2015,59,141,155,296
"10400",2343,2059,860,133,119,252
"10401",2209,1944,865,63,79,142
"10402",2315,1927,881,129,157,286
"10403",1749,1624,1008,31,44,75
"10404",1607,1512,1011,192,207,399
"10405",2111,1945,1019,41,50,91
"10406",2127,1945,1033,31,50,81
"10407",1917,1812,1046,94,97,191
"10408",2106,2015,1048,44,70,114
"10409",43,2213,1074,89,88,177
"10410",34,2010,1410,54,55,109
"10411",16,2019,1417,85,89,174
"10412",2026,1706,1422,49,36,85
"10413",38,2339,1423,140,149,289
"10414",2114,2028,1441,50,58,108
"10415",2213,1735,1458,102,100,202
"10416",2357,2209,1463,56,74,130
"10417",105,2205,1480,70,35,105
"10418",2314,2043,1483,65,93,158
"10419",2225,2157,1497,38,52,90
"10420",1,2109,1498,111,134,245
"10421",1648,1214,1507,34,44,78
"10422",2348,2020,1522,44,50,94
"10423",2334,2214,1525,67,79,146
"10424",37,2008,1540,118,133,251
"10425",2332,2230,1543,77,85,162
"10426",2157,1706,1573,67,71,138
"10427",2321,2000,1586,66,70,136
"10428",2327,2226,1597,74,91,165
"10429",2114,1800,1606,124,135,259
"10430",1349,1317,1620,68,74,142
"10431",2347,2003,1625,103,128,231
"10432",102,2014,1632,162,154,316
"10433",1921,1533,1633,134,133,267
"10434",24,2251,1644,79,101,180
"10435",1108,958,1654,40,63,103
"10436",2347,2035,1662,67,75,142
"10437",1357,1159,1669,32,34,66
"10438",2314,2218,1672,43,63,106
"10439",2114,1731,1688,71,96,167
"10440",2051,1943,1710,86,93,179
"10441",41,2106,1719,119,131,250
"10442",125,2052,1727,103,112,215
"10443",1938,1903,1732,71,78,149
"10444",2328,2008,1748,66,78,144
"10445",1158,1043,1749,70,62,132
"10446",38,2242,1764,95,112,207
"10447",1055,835,1766,38,50,88
"10448",2355,2216,1778,59,46,105
"10449",2008,1911,1779,76,81,157
"10450",2009,1855,1795,33,44,77
"10451",2306,2203,1814,38,48,86
"10452",2123,2023,1826,66,78,144
"10453",2324,2238,1832,73,83,156
"10454",150,2120,1839,141,150,291
"10455",1942,1843,1847,82,103,185
"10456",247,2236,1886,80,101,181
"10457",2031,1856,1889,37,61,98
"10458",1959,1831,59,44,51,95
"10459",1956,1537,62,32,62,94
"10460",1813,1441,846,72,96,168
"10461",1920,1806,1046,97,91,188
"10462",1821,1611,1400,37,51,88
"10463",2123,1814,1422,106,104,210
"10464",2253,2023,1483,44,73,117
"10465",31,2302,1490,87,122,209
"10466",1658,1552,1570,67,77,144
"10467",2357,2014,1595,46,69,115
"10468",1431,1312,1605,73,82,155
"10469",2255,1814,1632,35,34,69
"10470",1056,827,1746,51,62,113
"10471",15,1947,1751,31,57,88
"10472",1338,937,1753,35,42,77
"10473",1957,1540,1811,124,150,274
"10474",1231,940,1850,61,50,111
"10475",1331,1149,1893,134,149,283
"10476",2001,1837,59,47,57,104
"10477",2102,1926,1019,32,31,63
"10478",1730,1333,1087,40,38,78
"10479",3,2048,1091,111,78,189
"10480",2018,1710,1422,41,40,81
"10481",2309,2022,1498,59,87,146
"10482",5,1945,1540,86,110,196
"10483",1407,1131,1646,61,61,122
"10484",2345,1945,1678,42,35,77
"10485",2039,1641,1688,36,46,82
"10486",1720,1609,1765,95,114,209
"10487",2359,2249,1778,63,79,142
"10488",1910,1431,1811,77,81,158
"10489",2309,1938,1830,35,38,73
"10490",2329,1912,881,143,142,285
"10491",2244,2004,1091,32,34,66
"10492",1636,1318,1430,191,188,379
"10493",16,2108,1506,113,117,230
"10494",2318,2159,1525,51,64,115
"10495",1517,1144,1551,83,64,147
"10496",1601,1507,1557,48,52,100
"10497",1754,1656,1569,138,151,289
"10498",1609,1510,1589,31,45,76
"10499",1405,1044,1607,185,179,364
"10500",2326,1937,1625,82,102,184
"10501",1403,1225,1669,38,60,98
"10502",2054,1900,1724,59,70,129
"10503",1925,1851,1732,58,66,124
"10504",1810,1438,1741,120,98,218
"10505",1651,1145,1764,56,45,101
"10506",2038,1816,1789,41,46,87
"10507",2026,1659,1844,126,149,275
"10508",939,830,1874,51,65,116
"10509",1457,1243,1880,36,48,84
"10510",2230,1754,857,100,119,219
"10511",2229,2016,860,59,76,135
"10512",2142,1732,881,36,42,78
"10513",2038,1822,1015,31,38,69
"10514",2158,1747,1025,108,105,213
"10515",2144,1950,1033,48,55,103
"10516",119,2207,1042,122,147,269
"10517",2020,1922,1408,41,62,103
"10518",2225,1844,1416,180,179,359
"10519",2312,2208,1423,54,58,112
"10520",2156,1746,1424,183,181,364
"10521",307,14,1427,180,184,364
"10522",1418,1056,1430,53,46,99
"10523",138,2125,1439,108,115,223
"10524",2150,2107,1441,86,97,183
"10525",2210,1737,1458,99,102,201
"10526",2244,2146,1479,32,36,68
"10527",1140,827,1487,50,62,112
"10528",2335,2158,1490,31,58,89
"10529",115,58,1497,208,233,441
"10530",2335,2037,1498,85,102,187
"10531",2130,2020,1511,117,135,252
"10532",2327,2155,1538,41,65,106
"10533",2337,1909,1540,58,74,132
"10534",1325,1221,1578,40,36,76
"10535",2140,1648,1594,55,57,112
"10536",2142,2056,1603,131,141,272
"10537",1937,1449,1624,107,99,206
"10538",53,2045,1625,169,170,339
"10539",2344,2031,1662,64,71,135
"10540",1408,1222,1669,43,57,100
"10541",105,2127,1678,122,137,259
"10542",1641,1412,1705,35,42,77
"10543",2019,1947,1732,112,122,234
"10544",1652,1338,1741,42,38,80
"10545",1112,855,1746,67,90,157
"10546",25,1951,1751,41,61,102
"10547",1953,1605,1755,35,50,85
"10548",1806,1705,1821,53,80,133
"10549",105,10,1846,179,180,359
"10550",2330,2153,1889,216,238,454
"10551",2147,1706,857,57,71,128
"10552",1400,1258,1011,69,73,142
"10553",2101,1701,1025,51,59,110
"10554",2146,1811,1416,141,146,287
"10555",1756,1514,1575,40,44,84
"10556",1510,1029,1587,112,104,216
"10557",2344,2210,1724,229,260,489
"10558",1207,856,1746,126,91,217
"10559",2138,1727,1755,140,132,272
"10560",49,2343,1778,113,133,246
"10561",20,2053,1846,32,38,70
"10562",1237,934,1850,71,44,115
"10563",1949,1521,62,33,46,79
"10564",1913,1654,146,187,204,391
"10565",2054,1936,1019,31,41,72
"10566",1343,1231,1418,37,46,83
"10567",1601,1148,1474,80,68,148
"10568",1800,1442,1575,40,37,77
"10569",2259,1931,1586,51,41,92
"10570",1342,1119,1646,36,49,85
"10571",2320,2016,1662,47,56,103
"10572",1210,1103,1689,35,33,68
"10573",1613,1045,1712,34,35,69
"10574",35,2324,1778,104,114,218
"10575",1740,1403,1790,45,43,88
"10576",2334,2250,1814,71,95,166
"10577",1749,1317,1836,56,47,103
"10578",1124,1104,1841,113,134,247
"10579",1234,957,1850,70,67,137
"10580",1705,1609,6,35,39,74
"10581",1940,1817,137,225,227,452
"10582",2243,1820,881,97,90,187
"10583",48,2103,1002,101,113,214
"10584",1936,1804,1056,156,154,310
"10585",2339,2121,1091,87,111,198
"10586",1846,1642,1400,62,82,144
"10587",2347,2231,1421,111,121,232
"10588",2038,1726,1422,61,56,117
"10589",2219,2124,1441,115,114,229
"10590",2046,1637,1445,68,52,120
"10591",1653,1536,1482,155,151,306
"10592",1655,1231,1507,41,61,102
"10593",34,2104,1522,90,94,184
"10594",1636,1347,1547,135,122,257
"10595",2356,1944,1595,45,39,84
"10596",1956,1625,1606,46,40,86
"10597",1855,1614,1622,37,44,81
"10598",1512,1229,1646,126,119,245
"10599",2047,1904,1724,52,74,126
"10600",32,2020,1727,50,80,130
"10601",1115,837,1746,70,72,142
"10602",44,2351,1814,136,156,292
"10603",1255,1000,1850,85,70,155
"10604",948,839,52,36,54,90
"10605",1145,724,89,85,84,169
"10606",1721,1604,137,86,94,180
"10607",1851,1649,1400,67,89,156
"10608",1256,822,1432,33,42,75
"10609",1454,1141,1438,59,76,135
"10610",56,2041,1439,67,71,138
"10611",2103,1645,1458,32,50,82
"10612",2324,1901,1540,45,66,111
"10613",8,2106,1556,33,56,89
"10614",1732,1414,1687,41,49,90
"10615",1507,1022,1783,148,162,310
"10616",1830,1404,1811,37,54,91
"10617",1325,1231,1833,47,51,98
"10618",1557,1532,1838,39,57,96
"10619",2132,2006,47,51,56,107
"10620",1900,1518,846,119,133,252
"10621",2051,1718,1416,86,93,179
"10622",117,2326,1421,201,176,377
"10623",2320,2240,1433,68,80,148
"10624",2239,2149,1533,33,39,72
"10625",2310,1846,1540,31,51,82
"10626",1400,1253,1673,52,73,125
"10627",1617,1505,1765,32,50,82
"10628",1959,1519,62,35,44,79
"10629",2304,2044,1091,52,74,126
"10630",1832,1622,1400,48,62,110
"10631",1251,1109,1407,100,114,214
"10632",1339,1226,1448,54,51,105
"10633",1119,1043,1583,70,93,163
"10634",1531,1207,1656,60,57,117
"10635",1951,1601,1755,33,46,79
"10636",2019,1851,1795,43,40,83
"10637",1939,1829,5,42,44,86
"10638",2049,1928,59,94,108,202
"10639",1635,1520,137,40,50,90
"10640",1058,951,862,38,46,84
"10641",2206,1733,881,60,43,103
"10642",2133,1932,1033,37,37,74
"10643",2038,1719,1416,73,94,167
"10644",2317,2215,1423,59,65,124
"10645",1442,1118,1438,47,53,100
"10646",1533,1418,1482,36,48,84
"10647",1134,801,1487,44,36,80
"10648",1509,1406,1576,51,61,112
"10649",2108,2002,1661,40,47,87
"10650",2319,2223,1717,50,68,118
"10651",44,1935,1751,60,45,105
"10652",2000,1602,1755,42,47,89
"10653",1639,1524,1765,54,69,123
"10654",1359,1112,1,64,97,161
"10655",2022,1923,1408,43,63,106
"10656",2002,1642,1420,50,37,87
"10657",1633,1544,1541,81,84,165
"10658",2136,1906,1546,146,156,302
"10659",1445,1114,1552,85,64,149
"10660",2152,1949,1724,117,119,236
"10661",2301,1936,1748,39,46,85
"10662",1622,1516,1765,37,61,98
"10663",1830,1350,1811,37,40,77
"10664",1607,1128,1819,42,48,90
"10665",2116,1941,1889,82,106,188
"10666",1449,1343,1899,31,38,69
"10667",2124,2006,1019,61,71,132
"10668",2240,2017,1091,33,47,80
"10669",1417,929,1429,36,36,72
"10670",1642,1540,1624,46,60,106
"10671",1426,1239,1669,65,74,139
"10672",2123,1904,1724,95,74,169
"10673",1109,844,1746,70,79,149
"10674",1714,1601,33,32,31,63
"10675",2146,1935,1033,50,40,90
"10676",2356,2220,1421,120,110,230
"10677",2126,1758,1422,109,88,197
"10678",1420,1046,1430,55,36,91
"10679",1336,1211,1448,51,36,87
"10680",1805,1556,1451,99,91,190
"10681",24,2244,1490,80,104,184
"10682",1020,943,1492,37,48,85
"10683",2318,1829,1540,39,34,73
"10684",1749,1333,1637,45,43,88
"10685",1548,1338,1669,143,133,276
"10686",2324,1927,1719,42,32,74
"10687",2216,1941,1724,141,111,252
"10688",1654,1435,1750,111,95,206
"10689",1052,939,1791,55,69,124
"10690",1513,1144,1822,68,79,147
"10691",1936,1629,1852,36,44,80
"10692",1930,1823,33,168,173,341
"10693",2112,1726,1025,62,84,146
"10694",17,2210,1033,201,195,396
"10695",1731,1615,1056,31,45,76
"10696",1335,1221,1448,50,46,96
"10697",2349,2030,1451,46,60,106
"10698",33,2254,1490,89,114,203
"10699",2241,1947,1498,31,52,83
"10700",2259,1950,1506,37,40,77
"10701",26,1938,1521,42,38,80
"10702",1318,1218,1578,33,33,66
"10703",2252,1927,1586,37,37,74
"10704",1811,1410,1633,66,50,116
"10705",2319,2002,1662,39,42,81
"10706",1414,1213,1669,49,48,97
"10707",1751,1430,1687,60,65,125
"10708",10,2152,1724,255,242,497
"10709",1704,1528,1750,121,148,269
"10710",1703,1448,1765,78,33,111
"10711",2355,2246,1778,59,76,135
"10712",26,2153,1794,42,53,95
"10713",1411,1319,1833,93,99,192
"10714",1957,1750,1869,177,170,347
"10715",2320,2209,1888,42,49,91
"10716",1716,1551,137,81,81,162
"10717",2255,2028,1033,119,93,212
"10718",1834,1736,1046,51,61,112
"10719",1554,1145,1486,67,90,157
"10720",133,2311,1490,149,131,280
"10721",1028,949,1492,45,54,99
"10722",2125,2039,1603,115,124,239
"10723",1625,1508,1619,88,98,186
"10724",2251,1822,1632,31,42,73
"10725",1459,1254,1669,94,89,183
"10726",2003,1909,1729,35,44,79
"10727",1740,1607,1765,115,112,227
"10728",52,2325,1778,116,115,231
"10729",1737,1541,1869,37,41,78
"10730",2103,1701,1025,53,59,112
"10731",2229,2028,1033,93,93,186
"10732",111,2225,1091,179,175,354
"10733",2043,1737,1422,66,67,133
"10734",1537,1206,1438,102,101,203
"10735",24,2153,1490,80,53,133
"10736",2155,1931,1724,120,101,221
"10737",1615,1405,1750,72,65,137
"10738",1807,1703,1798,71,83,154
"10739",1854,1515,1844,34,45,79
"10740",1808,1622,1869,68,82,150
"10741",1652,1522,137,57,52,109
"10742",2235,2039,1033,99,104,203
"10743",1820,1716,1046,37,41,78
"10744",2025,1917,1408,46,57,103
"10745",39,2323,1421,163,173,336
"10746",2019,1708,1422,42,38,80
"10747",2216,2122,1441,112,112,224
"10748",2011,1640,1445,33,55,88
"10749",2358,2206,1490,54,66,120
"10750",2259,2136,1525,32,41,73
"10751",1620,1404,1547,119,139,258
"10752",1803,1534,1705,117,124,241
"10753",2249,2024,1724,174,154,328
"10754",1644,1333,1741,34,33,67
"10755",1049,802,1746,44,37,81
"10756",8,2258,1778,72,88,160
"10757",1526,1241,1780,116,106,222
"10758",1929,1459,1811,96,109,205
"10759",1754,1531,1835,38,61,99
"10760",1330,1044,1850,120,114,234
"10761",2119,1947,47,38,37,75
"10762",1553,1125,106,32,40,72
"10763",2339,2014,1002,32,64,96
"10764",2039,1834,1015,32,50,82
"10765",137,2333,1091,205,243,448
"10766",2000,1622,1416,35,37,72
"10767",2017,1659,1420,65,54,119
"10768",2045,1933,1603,56,58,114
"10769",1744,1346,1647,40,56,96
"10770",2310,1943,1748,48,53,101
"10771",1927,1635,1,392,420,812
"10772",2346,2124,1049,44,44,88
"10773",1430,1000,1429,49,67,116
"10774",1532,1408,1548,35,33,68
"10775",1654,1211,1606,64,76,140
"10776",1155,849,1607,61,64,125
"10777",2331,2029,1678,45,64,109
"10778",1711,1415,1741,74,82,156
"10779",23,1946,1751,46,56,102
"10780",1455,1405,1775,59,60,119
"10781",937,810,1823,31,35,66
"10782",1209,1028,1893,58,68,126
"10783",2130,2033,863,165,183,348
"10784",2305,2038,865,119,133,252
"10785",1815,1604,1400,31,44,75
"10786",2330,2210,1423,72,60,132
"10787",1948,1540,1424,55,55,110
"10788",1456,1128,1438,61,63,124
"10789",147,2222,1460,205,212,417
"10790",2305,2218,1479,53,68,121
"10791",2037,1919,1511,64,74,138
"10792",2331,2216,1525,64,81,145
"10793",6,1939,1540,87,104,191
"10794",1845,1402,1630,50,67,117
"10795",3,1946,1632,103,126,229
"10796",1749,1336,1637,45,46,91
"10797",7,2232,1644,62,82,144
"10798",1838,1433,1716,99,102,201
"10799",44,1947,1727,62,47,109
"10800",2330,2249,1832,84,99,183
"10801",1828,1318,1836,90,48,138
"10802",25,2006,1839,56,76,132
"10803",1957,1824,59,42,44,86
"10804",2055,1547,62,91,72,163
"10805",1825,1720,137,150,170,320
"10806",2024,1921,1526,45,61,106
"10807",1605,1234,1551,131,114,245
"10808",2124,1628,1594,39,37,76
"10809",2309,2216,1672,38,61,99
"10810",23,2042,1678,80,92,172
"10811",1749,1513,1717,33,43,76
"10812",1436,1104,1822,31,39,70
"10813",1853,1738,1847,33,38,71
"10814",1511,1220,1,136,165,301
"10815",2120,2019,5,145,154,299
"10816",1741,1607,33,59,37,96
"10817",1742,1634,35,74,61,135
"10818",2227,2102,47,106,112,218
"10819",2113,1922,59,119,102,221
"10820",2,2025,1002,55,75,130
"10821",2130,1950,1033,34,55,89
"10822",1856,1601,1400,72,41,113
"10823",111,2101,1410,91,106,197
"10824",2334,2203,1421,98,93,191
"10825",2025,1706,1422,48,36,84
"10826",1923,1812,1435,38,42,80
"10827",2328,2020,1498,78,85,163
"10828",2154,1622,1523,76,42,118
"10829",2002,1705,1546,52,35,87
"10830",2158,1627,1594,73,36,109
"10831",2019,1647,1606,69,62,131
"10832",2251,1844,1625,47,49,96
"10833",2325,2016,1662,45,56,101
"10834",5,2033,1678,62,83,145
"10835",1952,1845,1689,68,75,143
"10836",2012,1917,1729,44,52,96
"10837",1904,1819,1732,37,34,71
"10838",122,2047,1751,100,117,217
"10839",2108,1618,1755,110,63,173
"10840",2350,2234,1778,54,64,118
"10841",1757,1614,1798,61,34,95
"10842",1904,1421,1811,71,71,142
"10843",1805,1613,1863,65,43,108
"10844",2009,1532,62,45,57,102
"10845",2138,1956,1033,42,61,103
"10846",2356,2128,1091,104,118,222
"10847",2147,1829,1416,142,164,306
"10848",2307,2205,1423,51,55,106
"10849",2259,1926,1460,37,36,73
"10850",1308,1139,1409,88,102,190
"10851",2044,1725,1416,79,100,179
"10852",2143,1817,1422,126,107,233
"10853",2126,2017,1511,113,132,245
"10854",1113,1002,1680,45,67,112
"10855",33,1926,1751,49,36,85
"10856",2009,1554,1755,51,39,90
"10857",2,2054,1769,112,119,231
"10858",2225,2110,1795,169,179,348
"10859",2334,2124,1546,264,294,558
"10860",44,2316,1778,108,106,214
"10861",1906,1624,1779,82,64,146
"10862",2032,1637,1844,53,52,105
"10863",2204,1946,47,90,36,126
"10864",2338,2242,854,210,207,417
"10865",2313,1943,860,110,43,153
"10866",56,2042,874,47,40,87
"10867",2231,2047,1033,103,112,215
"10868",2311,2135,1407,56,40,96
"10869",132,2145,1417,166,175,341
"10870",2336,2231,1423,78,81,159
"10871",2342,2111,1427,43,36,79
"10872",2156,2022,1441,97,52,149
"10873",2317,2224,1479,72,74,146
"10874",105,2104,1595,122,119,241
"10875",1633,1128,1606,43,33,76
"10876",5,2235,1644,67,85,152
"10877",12,1953,1662,99,33,132
"10878",2320,2252,1708,103,112,215
"10879",1704,1132,1712,85,82,167
"10880",2256,2149,1717,32,34,66
"10881",2159,2018,1764,72,38,110
"10882",2346,1943,1772,104,33,137
"10883",13,2311,1814,110,116,226
"10884",940,826,1823,35,51,86
"10885",25,2020,1830,117,80,197
"10886",54,2037,1853,72,52,124
"10887",1906,1800,1046,83,85,168
"10888",5,2128,1074,51,43,94
"10889",1819,1540,1079,64,70,134
"10890",2019,1705,1422,42,35,77
"10891",1504,1119,1438,69,54,123
"10892",1121,758,1487,31,33,64
"10893",2354,2215,1490,50,75,125
"10894",1548,1303,1547,87,78,165
"10895",2057,2001,1602,37,41,78
"10896",2008,1919,1603,37,44,81
"10897",1413,1128,1646,67,58,125
"10898",30,2051,1678,87,101,188
"10899",1727,1443,1705,81,73,154
"10900",1044,809,1746,39,44,83
"10901",1,2210,1812,58,80,138
"10902",1324,1203,1843,86,93,179
"10903",232,2149,1869,63,54,117
"10904",1933,1620,8,53,55,108
"10905",1457,1155,1884,352,360,712
"10906",2102,1753,8,142,148,290
"10907",26,2121,54,181,187,368
"10908",1747,1411,1675,67,41,108
"10909",2157,1851,54,32,37,69
"10910",1103,816,686,33,33,66
"10911",2235,1922,54,70,68,138
"10912",1945,1627,8,65,62,127
"10913",1911,1557,8,31,32,63
"10914",2007,1654,8,87,89,176
"10915",2214,1903,54,49,49,98
"10916",1840,1520,1675,120,110,230
"10917",2352,2101,54,147,167,314
"10918",2114,2030,332,39,55,94
"10919",2103,2024,1493,33,39,72
"10920",2246,2110,1405,36,35,71
"10921",2355,1956,677,120,126,246
"10922",2233,2106,1863,93,101,194
"10923",2032,1953,2807,37,48,85
"10924",220,130,1212,210,215,425
"10925",2052,2002,1559,47,62,109
"10926",108,2359,794,108,124,232
"10927",2338,2028,291,38,43,81
"10928",58,2247,1553,43,52,95
"10929",1634,1545,1860,89,100,189
"10930",2156,2121,1493,86,96,182
"10931",336,2356,677,341,366,707
"10932",2250,2208,55,40,48,88
"10933",2143,2023,1863,43,58,101
"10934",2050,2014,2807,55,69,124
"10935",2000,1539,544,60,74,134
"10936",53,2,1212,123,127,250
"10937",2241,2135,230,51,60,111
"10938",47,2230,1553,32,35,67
"10939",2138,2031,316,158,156,314
"10940",2233,2138,834,58,63,121
"10941",2308,2129,164,98,109,207
"10942",1932,1822,125,57,62,119
"10943",2352,2310,1039,107,115,222
"10944",1924,1837,3574,44,47,91
"10945",2331,2216,1374,51,56,107
"10946",1908,1752,1159,163,152,315
"10947",2017,1838,2606,77,93,170
"10948",2007,1544,1351,67,79,146
"10949",1630,1539,284,70,74,144
"10950",2144,2051,2884,34,36,70
"10951",2109,2010,1292,144,150,294
"10952",1426,1327,690,31,37,68
"10953",2155,2043,2099,35,38,73
"10954",1406,1313,3626,51,68,119
"10955",2227,2111,3704,37,41,78
"10956",2313,1923,677,63,88,151
"10957",2029,1947,2807,34,42,76
"10958",2116,2025,47,36,50,86
"10959",1943,1847,512,48,57,105
"10960",1258,1159,1158,43,54,97
"10961",2400,2050,291,45,60,105
"10962",1748,1650,2106,88,95,183
"10963",1915,1832,3574,35,42,77
"10964",1955,1806,254,50,56,106
"10965",100,2112,49,50,72,122
"10966",2115,1750,3486,165,165,330
"10967",1621,1530,34,51,60,111
"10968",1723,1627,38,53,57,110
"10969",1939,1849,46,69,79,148
"10970",2213,2122,58,38,52,90
"10971",2314,2226,60,39,56,95
"10972",2028,1944,2807,33,39,72
"10973",1553,1500,1283,153,155,308
"10974",1625,1318,926,50,48,98
"10975",11,2257,794,36,57,93
"10976",1626,1313,7,186,198,384
"10977",6,2059,291,51,69,120
"10978",1905,1547,1495,85,87,172
"10979",2014,1807,198,59,82,141
"10980",2005,1911,316,65,76,141
"10981",1523,1450,243,83,90,173
"10982",1513,1329,1094,38,54,92
"10983",2137,1948,2904,132,148,280
"10984",2039,1949,52,44,49,93
"10985",1607,1447,1229,37,42,79
"10986",2130,2037,47,50,62,112
"10987",29,2335,1212,84,95,179
"10988",50,2139,291,95,109,204
"10989",1852,1513,1495,72,53,125
"10990",1821,1723,213,31,38,69
"10991",1452,1405,1191,32,35,67
"10992",2049,1750,37,39,45,84
"10993",2104,2028,1493,34,43,77
"10994",2033,1546,544,93,81,174
"10995",1653,1538,441,43,38,81
"10996",2246,2107,164,76,87,163
"10997",2333,2243,1039,73,83,156
"10998",2113,2029,1493,43,44,87
"10999",2056,1954,48,116,114,230
"11000",2136,2038,56,31,38,69
"11001",2131,1956,33,231,236,467
"11002",3,2045,45,78,95,173
"11003",1725,1420,19,105,115,220
"11004",37,2112,51,32,32,64
"11005",2351,2039,291,36,49,85
"11006",1538,1430,23,68,65,133
"11007",57,2054,985,47,69,116
"11008",1923,1842,3574,43,52,95
"11009",2055,1747,37,45,42,87
"11010",1917,1551,3486,47,46,93
"11011",2033,1941,52,38,41,79
"11012",1818,1640,33,38,40,78
"11013",2156,2113,2807,121,128,249
"11014",2323,2234,47,163,179,342
"11015",1750,1702,763,70,92,162
"11016",210,2158,985,120,133,253
"11017",2300,2213,1039,40,53,93
"11018",2322,2206,1374,42,46,88
"11019",2301,2131,2424,106,111,217
"11020",1304,858,3964,39,33,72
"11021",1315,1204,3734,60,49,109
"11022",1720,1528,1918,55,63,118
"11023",2244,2119,3704,54,49,103
"11024",1953,1758,254,48,48,96
"11025",44,2136,291,89,106,195
"11026",1649,1545,23,139,140,279
"11027",1421,1400,1136,31,50,81
"11028",2105,2024,1493,35,39,74
"11029",2027,1710,3486,117,125,242
"11030",2257,2211,55,32,46,78
"11031",2150,2054,41,155,169,324
"11032",1853,1810,465,68,75,143
"11033",1850,1724,35,60,54,114
"11034",1942,1858,932,157,158,315
"11035",55,2053,49,45,53,98
"11036",20,2004,677,130,129,259
"11037",16,2336,55,111,131,242
"11038",2045,1956,52,50,56,106
"11039",1632,1302,376,127,127,254
"11040",37,2349,1212,92,109,201
"11041",13,2300,794,38,60,98
"11042",1925,1805,125,50,45,95
"11043",1948,1815,465,123,80,203
"11044",2042,1739,37,32,34,66
"11045",1247,1110,9,47,50,97
"11046",1459,1352,770,104,122,226
"11047",1353,1306,1283,33,41,74
"11048",16,2105,291,61,75,136
"11049",1801,1651,715,56,61,117
"11050",1830,1718,35,40,48,88
"11051",2322,2209,1374,42,49,91
"11052",1234,1100,9,34,40,74
"11053",1642,1244,625,52,59,111
"11054",2317,2229,55,52,64,116
"11055",1949,1500,544,49,35,84
"11056",52,2132,45,127,142,269
"11057",1520,1148,376,55,53,108
"11058",1507,1405,23,37,40,77
"11059",2207,1908,37,117,123,240
"11060",2326,2211,1374,46,51,97
"11061",1637,1542,1860,92,97,189
"11062",107,2114,49,57,74,131
"11063",1549,1448,32,54,48,102
"11064",1622,1520,34,52,50,102
"11065",1746,1642,36,106,102,208
"11066",1733,1641,40,33,41,74
"11067",1946,1853,46,76,83,159
"11068",2026,1939,52,31,39,70
"11069",2400,2310,58,145,160,305
"11070",2147,2108,2807,112,123,235
"11071",2017,1529,544,77,64,141
"11072",2156,2106,39,211,216,427
"11073",1022,703,576,47,48,95
"11074",1901,1452,1495,81,32,113
"11075",1951,1737,198,36,52,88
"11076",1949,1851,316,49,56,105
"11077",1433,1359,243,33,39,72
"11078",2112,2013,41,117,128,245
"11079",117,34,1039,177,194,371
"11080",2230,2039,2904,185,199,384
"11081",2240,2111,2424,85,91,176
"11082",2113,1933,2606,133,148,281
"11083",2300,1900,3998,120,125,245
"11084",1753,1701,319,53,61,114
"11085",1958,1908,552,58,68,126
"11086",1930,1852,248,60,72,132
"11087",1835,1737,224,50,47,97
"11088",2150,2059,2884,40,44,84
"11089",2052,1950,2918,167,190,357
"11090",2237,2022,1789,97,107,204
"11091",2333,2117,2628,53,62,115
"11092",1508,1408,690,73,78,151
"11093",2123,2019,966,43,39,82
"11094",1921,1853,3738,41,53,94
"11095",2341,2041,269,56,61,117
"11096",2234,2117,3704,44,47,91
"11097",51,2053,677,161,178,339
"11098",1738,1654,31,83,89,172
"11099",1743,1649,40,43,49,92
"11100",1829,1738,42,59,68,127
"11101",1939,1849,46,69,79,148
"11102",2019,1928,50,54,58,112
"11103",2138,2044,1111,33,44,77
"11104",1348,1211,15,33,36,69
"11105",1952,1906,512,57,76,133
"11106",158,2251,51,113,131,244
"11107",32,2125,291,77,95,172
"11108",2338,2211,1178,113,76,189
"11109",2147,2047,41,152,162,314
"11110",2313,2234,1039,53,74,127
"11111",1853,1738,35,63,68,131
"11112",2357,2242,1374,77,82,159
"11113",2311,2232,1493,161,167,328
"11114",2337,1941,677,87,106,193
"11115",1904,1811,46,34,41,75
"11116",1944,1848,48,44,48,92
"11117",57,9,60,142,159,301
"11118",2201,2122,2807,126,137,263
"11119",1549,1118,293,79,83,162
"11120",2152,1656,544,172,151,323
"11121",1807,1656,352,32,46,78
"11122",300,159,794,205,239,444
"11123",18,2103,291,63,73,136
"11124",1829,1726,213,39,41,80
"11125",321,139,164,351,359,710
"11126",1949,1831,125,74,71,145
"11127",37,2355,1039,137,155,292
"11128",2039,1829,2904,74,69,143
"11129",1,2243,1374,81,83,164
"11130",1444,1350,28,49,50,99
"11131",1928,1831,512,33,41,74
"11132",2245,2152,1559,160,172,332
"11133",1828,1716,715,83,86,169
"11134",2336,2313,1178,111,138,249
"11135",1524,1432,30,54,62,116
"11136",1829,1651,33,49,51,100
"11137",29,2101,45,104,111,215
"11138",46,2142,291,91,112,203
"11139",100,2058,985,50,73,123
"11140",2145,2054,332,70,79,149
"11141",1736,1645,1860,151,160,311
"11142",1938,1750,254,33,40,73
"11143",1913,1540,3486,43,35,78
"11144",1657,1613,31,42,48,90
"11145",1722,1628,32,147,148,295
"11146",1608,1520,34,38,50,88
"11147",1707,1618,36,67,78,145
"11148",2259,2214,56,114,134,248
"11149",1815,1642,1229,165,157,322
"11150",2125,1654,544,145,149,294
"11151",1602,1507,27,37,37,74
"11152",1814,1723,295,39,43,82
"11153",1644,1532,441,34,32,66
"11154",1605,1459,618,50,69,119
"11155",1953,1643,1495,133,143,276
"11156",1952,1730,198,37,45,82
"11157",1530,1408,23,60,43,103
"11158",1925,1816,125,50,56,106
"11159",52,2046,985,42,61,103
"11160",1453,1431,243,53,71,124
"11161",1740,1717,473,35,52,87
"11162",2108,2020,41,113,135,248
"11163",2027,1916,35,157,166,323
"11164",1843,1757,932,98,97,195
"11165",1252,1100,9,52,40,92
"11166",1924,1611,3486,54,66,120
"11167",1344,1244,3744,79,64,143
"11168",1659,1607,34,89,97,186
"11169",1745,1642,36,105,102,207
"11170",1733,1640,40,33,40,73
"11171",1655,1539,1229,85,94,179
"11172",2005,1536,544,65,71,136
"11173",1602,1508,27,37,38,75
"11174",1405,1312,1283,45,47,92
"11175",1650,1329,926,75,59,134
"11176",1822,1706,352,47,56,103
"11177",1823,1455,1495,43,35,78
"11178",1613,1457,23,103,92,195
"11179",1825,1720,213,35,35,70
"11180",1130,1024,1167,40,39,79
"11181",1006,901,2002,46,46,92
"11182",1625,1207,11,65,67,132
"11183",2033,1946,41,78,101,179
"11184",1856,1802,465,71,67,138
"11185",2257,2212,1039,37,52,89
"11186",2010,1812,2904,45,52,97
"11187",1915,1758,35,85,88,173
"11188",2053,1910,2606,113,125,238
"11189",1753,1701,319,53,61,114
"11190",2134,2031,3818,39,51,90
"11191",2120,2014,2788,40,59,99
"11192",2005,1909,21,35,39,74
"11193",2026,1945,43,66,75,141
"11194",2050,2014,2807,55,69,124
"11195",9,2321,1212,64,81,145
"11196",1701,1600,2106,41,45,86
"11197",17,2330,1039,117,130,247
"11198",2139,1816,2008,119,106,225
"11199",2019,1716,2008,39,46,85
"11200",2131,1825,2008,109,115,224
"11201",2020,1707,2008,38,37,75
"11202",2023,1721,2008,41,51,92
"11203",2043,1731,2008,61,61,122
"11204",2156,1856,2008,134,146,280
"11205",2353,2300,2009,95,105,200
"11206",2255,2201,2009,33,46,79
"11207",12,2309,2009,110,114,224
"11208",2320,2215,2009,62,60,122
"11209",2256,2155,2009,32,40,72
"11210",2328,2235,2009,66,80,146
"11211",1723,1411,2010,38,36,74
"11212",1728,1408,2010,46,33,79
"11213",1718,1411,2010,33,36,69
"11214",1733,1420,2010,46,45,91
"11215",1722,1417,2010,40,42,82
"11216",1726,1418,2010,39,43,82
"11217",1659,1555,2025,56,54,110
"11218",1749,1651,2025,106,110,216
"11219",1707,1544,2025,64,43,107
"11220",1645,1545,2025,42,44,86
"11221",1738,1639,2025,95,98,193
"11222",1733,1639,2025,78,84,162
"11223",1808,1708,2025,121,125,246
"11224",950,747,2026,33,32,65
"11225",39,2102,2027,104,102,206
"11226",24,2018,2027,94,58,152
"11227",53,2111,2027,118,111,229
"11228",1,2038,2027,66,78,144
"11229",2400,2032,2027,65,72,137
"11230",2344,2017,2027,49,57,106
"11231",5,2028,2027,70,68,138
"11232",113,2150,2027,143,150,293
"11233",2349,1957,2027,49,32,81
"11234",46,2106,2027,116,106,222
"11235",1422,1037,2036,63,32,95
"11236",1432,1157,2041,40,32,72
"11237",1526,1248,2041,97,83,180
"11238",1449,1159,2041,57,34,91
"11239",1442,1225,2041,53,60,113
"11240",1436,1209,2041,44,44,88
"11241",1519,1250,2041,90,85,175
"11242",1524,1228,2041,92,63,155
"11243",1456,1211,2041,64,46,110
"11244",1514,1244,2041,82,79,161
"11245",2250,2112,2042,61,57,118
"11246",2244,2053,2042,100,88,188
"11247",2231,2057,2042,40,40,80
"11248",2303,2112,2042,84,69,153
"11249",2245,2105,2042,56,50,106
"11250",2259,2119,2042,70,64,134
"11251",2243,2102,2042,54,47,101
"11252",2358,2226,2042,137,143,280
"11253",2239,2053,2042,60,54,114
"11254",2220,1849,2044,76,79,155
"11255",2325,1945,2044,143,135,278
"11256",2204,1848,2044,60,78,138
"11257",2155,1824,2044,51,54,105
"11258",2300,1902,2044,116,92,208
"11259",2135,1807,2044,33,37,70
"11260",2149,1814,2044,45,44,89
"11261",2222,1851,2044,78,81,159
"11262",2346,2016,2044,162,166,328
"11263",2144,1805,2044,42,35,77
"11264",2216,1851,2044,72,81,153
"11265",1453,1338,2048,39,38,77
"11266",1506,1347,2048,52,47,99
"11267",1704,1534,2048,115,104,219
"11268",1647,1523,2048,98,93,191
"11269",1545,1429,2048,36,39,75
"11270",1603,1430,2048,54,40,94
"11271",1459,1350,2048,45,50,95
"11272",1634,1520,2048,85,90,175
"11273",1615,1454,2048,66,64,130
"11274",7,1959,2050,85,69,154
"11275",17,2020,2050,95,90,185
"11276",35,2041,2050,118,111,229
"11277",111,2122,2050,149,152,301
"11278",37,2052,2050,115,122,237
"11279",53,2055,2050,131,125,256
"11280",115,2116,2050,158,146,304
"11281",2331,1940,2050,54,50,104
"11282",52,2101,2050,130,131,261
"11283",1207,1116,2058,83,89,172
"11284",1537,1438,2060,93,106,199
"11285",2049,1951,2062,87,97,184
"11286",2002,1902,2062,44,52,96
"11287",2200,2049,2062,137,134,271
"11288",2052,1953,2062,94,103,197
"11289",1852,1746,2069,143,146,289
"11290",1712,1605,2069,48,45,93
"11291",1726,1626,2069,57,66,123
"11292",1731,1556,2069,62,36,98
"11293",1143,1032,2079,78,82,160
"11294",1311,1211,2082,46,41,87
"11295",1336,1236,2082,68,66,134
"11296",1342,1244,2082,74,74,148
"11297",1356,1303,2082,88,93,181
"11298",1745,1404,2105,63,49,112
"11299",1750,1420,2105,83,85,168
"11300",2007,1646,2109,125,111,236
"11301",1937,1711,2122,58,81,139
"11302",1925,1627,2122,46,37,83
"11303",2002,1702,2122,83,72,155
"11304",1910,1626,2122,31,36,67
"11305",2248,2158,2131,31,43,74
"11306",1151,1028,2132,161,158,319
"11307",1049,939,2132,102,109,211
"11308",1806,1550,2147,69,65,134
"11309",1755,1539,2147,58,54,112
"11310",1738,1523,2147,41,38,79
"11311",1744,1535,2147,47,50,97
"11312",1757,1549,2147,60,64,124
"11313",1913,1749,2162,67,69,136
"11314",2033,1903,2162,149,143,292
"11315",1839,1713,2162,31,33,64
"11316",1859,1741,2162,55,61,116
"11317",1932,1810,2162,84,90,174
"11318",1851,1734,2162,45,54,99
"11319",2346,1939,2171,50,39,89
"11320",8,2012,2171,71,72,143
"11321",57,2105,2171,120,125,245
"11322",2338,1943,2171,41,43,84
"11323",2346,1959,2171,49,59,108
"11324",21,2038,2171,84,98,182
"11325",2340,1939,2171,43,39,82
"11326",28,2034,2171,91,94,185
"11327",2359,2001,2171,67,61,128
"11328",131,2139,2171,154,159,313
"11329",3,2017,2171,66,77,143
"11330",1240,908,2172,91,81,172
"11331",1613,1353,2174,100,48,148
"11332",1552,1425,2174,84,80,164
"11333",1539,1408,2174,66,63,129
"11334",1537,1358,2174,64,53,117
"11335",1047,951,2176,33,41,74
"11336",1254,940,2183,62,55,117
"11337",1910,1530,2198,92,75,167
"11338",1850,1525,2198,72,70,142
"11339",1830,1457,2198,52,42,94
"11340",1947,1620,2198,129,125,254
"11341",1346,1239,2200,48,59,107
"11342",2031,1931,2212,103,101,204
"11343",2137,2038,2212,169,168,337
"11344",2018,1918,2212,90,88,178
"11345",1621,1458,2213,80,82,162
"11346",1541,1421,2213,40,45,85
"11347",2115,2019,2216,80,89,169
"11348",1446,1343,2223,51,47,98
"11349",1141,802,2240,47,47,94
"11350",1207,1044,2249,36,39,75
"11351",1343,1210,2253,50,40,90
"11352",1415,1253,2253,82,83,165
"11353",1340,1212,2253,47,42,89
"11354",1355,1224,2253,62,54,116
"11355",1332,1209,2253,37,39,76
"11356",1324,1212,2253,31,42,73
"11357",943,838,2254,36,33,69
"11358",1126,1016,2254,139,131,270
"11359",2324,2238,2261,72,78,150
"11360",2302,2215,2261,51,55,106
"11361",2246,2200,2261,32,40,72
"11362",2314,2223,2261,62,63,125
"11363",1539,1152,2268,72,62,134
"11364",1813,1559,2274,94,74,168
"11365",1844,1653,2274,120,123,243
"11366",1733,1537,2274,54,52,106
"11367",1713,1524,2274,34,39,73
"11368",1718,1527,2274,39,42,81
"11369",1724,1530,2274,43,43,86
"11370",1722,1537,2274,43,52,95
"11371",1721,1532,2274,42,47,89
"11372",1721,1533,2274,42,48,90
"11373",1711,1517,2274,32,32,64
"11374",2108,1729,2276,58,41,99
"11375",2223,1859,2276,133,131,264
"11376",2218,1842,2276,126,114,240
"11377",2114,1756,2276,64,68,132
"11378",1334,1228,2277,62,63,125
"11379",1555,1443,2277,203,198,401
"11380",1319,1209,2277,47,44,91
"11381",1318,1214,2277,46,49,95
"11382",1318,1211,2277,46,46,92
"11383",1849,1633,2278,75,68,143
"11384",1826,1622,2278,52,57,109
"11385",1835,1632,2278,61,67,128
"11386",1827,1609,2278,53,44,97
"11387",1823,1616,2278,51,46,97
"11388",1814,1557,2278,40,32,72
"11389",1823,1610,2278,49,45,94
"11390",1846,1643,2278,71,73,144
"11391",1951,1745,2278,137,140,277
"11392",2014,1816,2278,160,171,331
"11393",2309,2141,2280,77,83,160
"11394",2337,2212,2280,122,131,253
"11395",2251,2117,2280,76,76,152
"11396",2238,2103,2280,72,68,140
"11397",2357,2233,2280,137,147,284
"11398",2238,2111,2280,69,76,145
"11399",2218,2055,2280,52,60,112
"11400",2224,2054,2280,55,59,114
"11401",2213,2044,2280,40,43,83
"11402",1249,1201,2283,79,81,160
"11403",2338,2022,2288,31,37,68
"11404",45,2135,2288,98,105,203
"11405",22,2043,2288,75,53,128
"11406",23,2053,2288,76,68,144
"11407",2355,2029,2288,48,44,92
"11408",2357,2047,2288,50,62,112
"11409",2355,2030,2288,48,45,93
"11410",45,2137,2288,98,112,210
"11411",2348,2034,2288,41,49,90
"11412",151,2240,2288,164,175,339
"11413",1706,1541,2289,63,51,114
"11414",1605,1505,2294,43,45,88
"11415",1759,1611,2294,157,111,268
"11416",1825,1731,2294,183,191,374
"11417",1607,1508,2294,45,48,93
"11418",1702,1553,2294,97,90,187
"11419",1421,1105,2295,41,35,76
"11420",1431,1106,2295,51,36,87
"11421",1303,1207,2296,78,74,152
"11422",1333,1244,2296,103,111,214
"11423",1226,1134,2296,36,41,77
"11424",1921,1556,2298,36,31,67
"11425",1950,1602,2298,65,37,102
"11426",1921,1600,2298,36,35,71
"11427",2029,1724,2298,104,119,223
"11428",2119,1801,2298,154,156,310
"11429",1146,946,2302,61,51,112
"11430",1237,1041,2302,112,106,218
"11431",1131,932,2302,46,37,83
"11432",1547,1424,2304,88,79,167
"11433",1721,1615,2308,52,55,107
"11434",1717,1610,2308,53,50,103
"11435",1933,1828,2308,184,188,372
"11436",1940,1606,2317,85,81,166
"11437",1902,1516,2317,47,31,78
"11438",1913,1535,2317,58,50,108
"11439",1636,1542,2318,134,137,271
"11440",1613,1500,2318,111,95,206
"11441",1816,1458,2334,61,53,114
"11442",1826,1510,2334,71,65,136
"11443",1933,1623,2334,138,138,276
"11444",1813,1444,2334,58,39,97
"11445",1641,1507,2336,42,47,89
"11446",1635,1451,2336,36,31,67
"11447",1653,1517,2336,54,57,111
"11448",1739,1556,2336,100,96,196
"11449",1438,1131,2340,51,66,117
"11450",1422,1102,2340,35,37,72
"11451",1838,1646,2346,45,41,86
"11452",1923,1727,2346,90,82,172
"11453",1940,1754,2346,107,109,216
"11454",1835,1648,2346,42,43,85
"11455",1835,1654,2346,42,49,91
"11456",1405,1205,2348,63,55,118
"11457",2309,2157,2357,51,42,93
"11458",44,2344,2357,141,149,290
"11459",2337,2227,2357,79,72,151
"11460",2338,2236,2357,75,81,156
"11461",2315,2212,2357,52,57,109
"11462",2304,2206,2357,42,51,93
"11463",2020,1843,2376,35,38,73
"11464",2204,2020,2376,139,135,274
"11465",2124,1916,2376,99,71,170
"11466",2030,1846,2376,45,41,86
"11467",2116,1936,2376,91,91,182
"11468",1844,1532,2380,93,93,186
"11469",1825,1507,2380,74,68,142
"11470",1804,1448,2380,40,33,73
"11471",1751,1437,2380,40,38,78
"11472",1448,1047,2386,67,42,109
"11473",1809,1427,2386,270,262,532
"11474",2134,1805,2390,72,80,152
"11475",1728,1347,2393,61,47,108
"11476",1258,1124,2399,138,144,282
"11477",2035,1901,2400,35,41,76
"11478",2056,1930,2400,54,70,124
"11479",1351,1138,2402,119,88,207
"11480",1301,1054,2402,69,44,113
"11481",1800,1440,2405,41,35,76
"11482",1756,1440,2405,37,35,72
"11483",1757,1442,2405,38,37,75
"11484",1819,1503,2405,64,58,122
"11485",1811,1506,2405,52,61,113
"11486",1459,1400,2407,108,105,213
"11487",1350,1250,2407,39,35,74
"11488",19,2334,2408,37,34,71
"11489",21,2343,2408,39,43,82
"11490",2338,2224,2413,44,69,113
"11491",2230,2136,2418,126,129,255
"11492",2105,2012,2418,41,52,93
"11493",2131,2043,2418,76,83,159
"11494",2101,2022,2418,42,62,104
"11495",2123,2043,2418,68,83,151
"11496",2134,2045,2418,75,85,160
"11497",2145,2051,2418,90,91,181
"11498",2050,1942,2425,96,97,193
"11499",2001,1851,2425,47,46,93
"11500",2038,1926,2425,82,81,163
"11501",2002,1902,2425,48,57,105
"11502",2150,1910,2425,159,65,224
"11503",2241,2126,2425,203,201,404
"11504",2023,1915,2425,69,70,139
"11505",1641,1509,2427,60,54,114
"11506",1638,1513,2427,57,58,115
"11507",1638,1512,2427,57,57,114
"11508",1320,1200,2429,37,35,72
"11509",1513,1348,2429,150,143,293
"11510",1355,1236,2429,72,71,143
"11511",1324,1214,2429,41,49,90
"11512",1428,1304,2429,110,99,209
"11513",1207,836,2432,41,46,87
"11514",1231,847,2432,65,57,122
"11515",1351,1230,2433,61,60,121
"11516",1333,1211,2433,43,41,84
"11517",1351,1230,2433,56,60,116
"11518",1235,1059,2434,60,54,114
"11519",1237,1109,2434,67,64,131
"11520",1317,1001,2435,120,111,231
"11521",1159,845,2435,40,35,75
"11522",1231,912,2435,74,62,136
"11523",1327,959,2435,130,104,234
"11524",1727,1634,2442,43,49,92
"11525",1802,1713,2442,83,88,171
"11526",1812,1713,2442,88,88,176
"11527",2357,2026,2447,56,56,112
"11528",1133,1031,2453,69,76,145
"11529",1917,1605,2472,82,78,160
"11530",1852,1534,2472,45,35,80
"11531",1827,1523,2472,47,48,95
"11532",1806,1615,2474,32,40,72
"11533",1828,1610,2474,54,35,89
"11534",1839,1638,2474,72,63,135
"11535",1944,1802,2474,132,147,279
"11536",1941,1744,2474,129,129,258
"11537",1805,1607,2474,33,32,65
"11538",1803,1545,2479,76,65,141
"11539",1727,1526,2479,40,46,86
"11540",1817,1549,2479,90,69,159
"11541",2148,2053,2481,76,83,159
"11542",2116,2027,2481,46,57,103
"11543",2113,2017,2481,41,47,88
"11544",2233,2119,2481,119,109,228
"11545",2121,2024,2481,51,54,105
"11546",1341,1217,2482,109,107,216
"11547",1225,1110,2482,33,40,73
"11548",1308,1159,2482,76,89,165
"11549",1244,1122,2482,52,52,104
"11550",2034,1703,2488,37,33,70
"11551",2105,1736,2488,68,66,134
"11552",2308,1916,2488,191,166,357
"11553",2131,1751,2488,94,81,175
"11554",2132,1743,2488,95,73,168
"11555",2212,1843,2488,135,133,268
"11556",2310,1929,2488,193,179,372
"11557",106,2056,2489,141,106,247
"11558",2005,1614,2492,49,34,83
"11559",2248,1905,2492,209,205,414
"11560",2026,1615,2492,62,32,94
"11561",2027,1635,2492,66,55,121
"11562",249,120,2493,232,240,472
"11563",49,2325,2493,112,125,237
"11564",3,2229,2493,66,69,135
"11565",2110,1756,2496,78,81,159
"11566",2041,1730,2496,49,55,104
"11567",2145,1823,2496,113,108,221
"11568",2102,1754,2496,73,79,152
"11569",2027,1711,2496,35,36,71
"11570",2352,2050,2496,240,255,495
"11571",2102,1747,2496,70,72,142
"11572",2059,1739,2496,64,64,128
"11573",2029,1725,2496,37,50,87
"11574",2145,1830,2496,111,115,226
"11575",1855,1656,2497,78,58,136
"11576",1834,1705,2497,57,67,124
"11577",2010,1838,2497,153,160,313
"11578",1835,1703,2497,71,78,149
"11579",1904,1729,2497,87,91,178
"11580",1801,1627,2497,37,42,79
"11581",1829,1641,2497,52,43,95
"11582",1916,1743,2497,99,105,204
"11583",1950,1759,2497,146,134,280
"11584",1841,1709,2497,62,71,133
"11585",1833,1703,2497,56,65,121
"11586",1502,1415,2499,42,55,97
"11587",1456,1400,2499,36,40,76
"11588",1455,1359,2499,35,39,74
"11589",1707,1612,2499,167,172,339
"11590",1454,1356,2499,34,36,70
"11591",1520,1402,2503,133,133,266
"11592",2400,2259,2515,97,99,196
"11593",2324,2230,2515,61,70,131
"11594",2257,2151,2515,34,31,65
"11595",2346,2250,2515,83,90,173
"11596",1459,1125,2520,52,33,85
"11597",1540,1227,2520,90,95,185
"11598",1521,1154,2520,71,62,133
"11599",1516,1142,2520,66,50,116
"11600",1232,1036,2534,33,46,79
"11601",2353,2155,2548,56,65,121
"11602",2059,1959,2562,144,144,288
"11603",1922,1823,2562,47,48,95
"11604",1913,1819,2562,38,44,82
"11605",1436,1126,2564,33,41,74
"11606",1521,1118,2568,44,33,77
"11607",1849,1523,2572,102,98,200
"11608",1754,1431,2572,47,46,93
"11609",1740,1416,2572,33,31,64
"11610",1746,1421,2572,42,36,78
"11611",1858,1525,2572,111,100,211
"11612",1848,1501,2572,101,76,177
"11613",1000,810,2573,46,50,96
"11614",1001,757,2573,54,42,96
"11615",1257,1120,2576,50,55,105
"11616",1314,1117,2576,67,52,119
"11617",1626,1530,2581,59,60,119
"11618",1606,1514,2581,43,44,87
"11619",1654,1601,2581,94,91,185
"11620",1615,1518,2581,52,48,100
"11621",1623,1529,2581,58,59,117
"11622",1711,1607,2581,106,97,203
"11623",1657,1542,2585,34,39,73
"11624",1703,1546,2585,40,43,83
"11625",1754,1633,2585,91,90,181
"11626",1933,1806,2585,190,183,373
"11627",1119,759,2586,40,44,84
"11628",1109,758,2586,32,43,75
"11629",1131,810,2586,54,55,109
"11630",1714,1544,2589,68,69,137
"11631",1808,1601,2589,122,86,208
"11632",1737,1544,2589,91,69,160
"11633",1713,1541,2589,69,66,135
"11634",1653,1526,2589,47,51,98
"11635",1646,1525,2592,37,38,75
"11636",1750,1620,2592,103,93,196
"11637",1702,1527,2592,53,40,93
"11638",2334,2028,2597,45,53,98
"11639",2333,2023,2597,39,48,87
"11640",15,2105,2597,81,90,171
"11641",31,2112,2597,97,97,194
"11642",2326,2020,2597,32,45,77
"11643",2328,2017,2597,34,42,76
"11644",2340,2027,2597,46,52,98
"11645",5,2048,2597,71,73,144
"11646",2324,2023,2597,35,48,83
"11647",2350,2029,2597,56,54,110
"11648",2056,1903,2598,86,88,174
"11649",2003,1812,2598,38,37,75
"11650",2014,1815,2598,44,40,84
"11651",2049,1857,2598,79,82,161
"11652",2021,1825,2598,51,50,101
"11653",2130,1935,2598,120,120,240
"11654",2105,1909,2598,95,94,189
"11655",2204,2014,2598,154,159,313
"11656",2054,1902,2598,84,87,171
"11657",2117,1909,2598,107,94,201
"11658",2058,1905,2598,88,90,178
"11659",1511,1340,2600,47,40,87
"11660",1554,1430,2600,92,90,182
"11661",1943,1916,2603,53,76,129
"11662",2001,1922,2603,71,82,153
"11663",2021,1956,2603,93,116,209
"11664",2133,2101,2603,163,181,344
"11665",924,751,2606,32,31,63
"11666",948,816,2606,56,56,112
"11667",951,824,2606,59,64,123
"11668",1421,1055,2622,49,40,89
"11669",1751,1625,2625,81,60,141
"11670",1735,1632,2625,65,67,132
"11671",1756,1654,2625,86,89,175
"11672",1955,1853,2625,205,208,413
"11673",1701,1556,2625,31,31,62
"11674",1744,1636,2625,74,71,145
"11675",1707,1606,2625,37,41,78
"11676",1734,1629,2625,67,64,131
"11677",1750,1652,2625,80,87,167
"11678",1612,1517,2631,42,42,84
"11679",1612,1520,2631,42,45,87
"11680",1609,1520,2631,39,45,84
"11681",1625,1531,2631,52,53,105
"11682",2227,2039,2651,66,79,145
"11683",2157,2011,2651,38,51,89
"11684",2305,2110,2651,78,77,155
"11685",2211,2024,2651,40,54,94
"11686",2217,2015,2651,54,55,109
"11687",1448,1127,2652,38,42,80
"11688",1453,1124,2652,43,39,82
"11689",1446,1123,2652,36,38,74
"11690",2343,2238,2654,86,88,174
"11691",2345,2239,2654,88,89,177
"11692",2325,2224,2654,66,74,140
"11693",2346,2236,2654,89,86,175
"11694",1552,1221,2670,88,88,176
"11695",1459,1115,2670,160,140,300
"11696",939,822,2674,47,57,104
"11697",2112,2005,2675,153,150,303
"11698",1924,1814,2675,45,39,84
"11699",1911,1806,2675,32,31,63
"11700",2003,1904,2675,84,89,173
"11701",1303,1236,2680,78,91,169
"11702",947,816,2687,47,46,93
"11703",2252,2154,2692,42,39,81
"11704",2337,2251,2692,87,96,183
"11705",49,2358,2692,159,163,322
"11706",2304,2216,2692,55,61,116
"11707",2248,2154,2692,38,39,77
"11708",2353,2300,2692,103,105,208
"11709",1854,1714,2695,68,70,138
"11710",1838,1652,2695,52,48,100
"11711",1955,1816,2695,129,132,261
"11712",1959,1819,2695,133,135,268
"11713",1825,1700,2705,42,32,74
"11714",1838,1728,2705,60,60,120
"11715",1852,1726,2705,69,58,127
"11716",1812,1700,2705,34,32,66
"11717",1839,1728,2705,56,60,116
"11718",1354,1256,2712,49,52,101
"11719",1737,1424,2715,49,49,98
"11720",1839,1522,2715,106,107,213
"11721",1745,1433,2715,52,58,110
"11722",1834,1456,2715,101,81,182
"11723",1402,1208,2719,71,73,144
"11724",2044,1836,2721,52,46,98
"11725",2038,1832,2721,40,42,82
"11726",2101,1902,2721,65,72,137
"11727",2032,1822,2721,38,32,70
"11728",2057,1903,2721,63,73,136
"11729",2139,1936,2721,101,106,207
"11730",928,807,2723,31,32,63
"11731",1706,1502,2724,109,112,221
"11732",1557,1401,2724,40,51,91
"11733",1615,1430,2724,58,80,138
"11734",1604,1350,2724,47,40,87
"11735",1607,1354,2724,50,44,94
"11736",1615,1420,2724,58,70,128
"11737",9,2208,2726,122,133,255
"11738",40,2241,2726,153,166,319
"11739",2326,2108,2726,79,73,152
"11740",2334,2125,2726,77,80,157
"11741",43,2222,2726,156,147,303
"11742",2252,2038,2726,41,39,80
"11743",2339,2126,2726,92,91,183
"11744",26,2210,2726,139,135,274
"11745",2252,2046,2726,45,51,96
"11746",2113,1806,2728,101,96,197
"11747",2050,1722,2728,76,52,128
"11748",2110,1759,2728,100,89,189
"11749",2020,1708,2728,48,38,86
"11750",2020,1716,2728,48,46,94
"11751",2113,1809,2728,99,99,198
"11752",1343,1231,2729,49,41,90
"11753",2222,2111,2731,157,136,293
"11754",2024,1931,2731,34,36,70
"11755",2121,2029,2731,89,94,183
"11756",2043,1952,2731,53,57,110
"11757",2038,1946,2731,48,51,99
"11758",2038,1947,2731,48,52,100
"11759",2325,2235,2731,215,220,435
"11760",1348,1219,2734,122,119,241
"11761",1222,1054,2734,41,34,75
"11762",1440,1139,2736,57,59,116
"11763",1441,1144,2736,58,64,122
"11764",1434,1126,2736,77,71,148
"11765",2006,1827,2748,99,82,181
"11766",2034,1909,2748,127,124,251
"11767",1924,1737,2748,57,32,89
"11768",1938,1746,2748,72,41,113
"11769",1935,1803,2748,68,58,126
"11770",1957,1836,2748,90,91,181
"11771",1856,1737,2748,32,32,64
"11772",2023,1902,2748,116,117,233
"11773",2025,1907,2748,118,122,240
"11774",2046,1915,2748,139,130,269
"11775",1938,1811,2748,71,66,137
"11776",1244,1101,2750,42,46,88
"11777",1251,1048,2750,49,33,82
"11778",1638,1551,2755,35,36,71
"11779",1840,1756,2755,157,161,318
"11780",1829,1743,2755,146,148,294
"11781",1648,1551,2755,45,36,81
"11782",1819,1732,2755,136,137,273
"11783",1748,1640,2755,105,85,190
"11784",1700,1616,2755,57,61,118
"11785",1646,1603,2755,43,48,91
"11786",2032,1849,2759,47,44,91
"11787",2046,1903,2759,61,58,119
"11788",1909,1717,2759,73,62,135
"11789",2216,2041,2759,151,156,307
"11790",2030,1845,2759,45,40,85
"11791",1523,1445,2769,58,65,123
"11792",1630,1520,2773,80,85,165
"11793",1055,902,2776,55,50,105
"11794",1036,845,2776,47,55,102
"11795",1746,1626,2778,84,82,166
"11796",1656,1536,2778,40,33,73
"11797",1655,1541,2778,34,38,72
"11798",1733,1609,2778,71,65,136
"11799",1700,1542,2778,38,38,76
"11800",2344,2043,2782,59,62,121
"11801",2326,2019,2782,41,38,79
"11802",2326,2015,2782,41,34,75
"11803",2335,2035,2782,50,54,104
"11804",2357,2049,2782,74,68,142
"11805",2353,2051,2782,68,70,138
"11806",2322,2027,2782,39,46,85
"11807",2328,2026,2782,43,45,88
"11808",2345,2047,2782,60,66,126
"11809",127,2220,2782,162,159,321
"11810",1855,1740,2784,43,60,103
"11811",1709,1351,2791,37,36,73
"11812",1719,1404,2791,47,49,96
"11813",1718,1402,2791,46,47,93
"11814",1123,1005,2792,60,65,125
"11815",1319,1153,2792,179,173,352
"11816",1055,931,2792,35,31,66
"11817",2235,2108,2800,93,98,191
"11818",2221,2055,2800,79,85,164
"11819",2236,2113,2800,94,103,197
"11820",2133,2011,2800,31,41,72
"11821",2143,2023,2800,41,53,94
"11822",1448,1124,2802,41,49,90
"11823",1552,1222,2802,107,107,214
"11824",1443,1117,2802,38,42,80
"11825",1510,1150,2802,65,75,140
"11826",1440,1111,2802,35,36,71
"11827",1450,1125,2802,43,50,93
"11828",2305,2215,2803,68,70,138
"11829",2256,2157,2803,56,52,108
"11830",2304,2218,2803,68,73,141
"11831",2241,2152,2803,44,47,91
"11832",2322,2231,2803,85,86,171
"11833",2234,2138,2803,37,33,70
"11834",2356,2247,2803,116,102,218
"11835",2232,2149,2803,35,44,79
"11836",2237,2111,2804,112,116,228
"11837",2237,2059,2804,110,104,214
"11838",2254,2126,2804,129,131,260
"11839",2217,2042,2804,90,87,177
"11840",2215,2030,2804,88,75,163
"11841",2241,2053,2804,116,98,214
"11842",2126,1948,2804,42,33,75
"11843",2241,2115,2804,116,120,236
"11844",2251,2122,2804,122,127,249
"11845",1101,1010,2807,72,70,142
"11846",1724,1626,2809,44,46,90
"11847",1712,1624,2809,32,44,76
"11848",1511,1350,2811,66,60,126
"11849",1520,1347,2811,70,57,127
"11850",2335,2022,2815,43,47,90
"11851",2349,2044,2815,57,69,126
"11852",111,2158,2815,139,143,282
"11853",23,2105,2815,91,90,181
"11854",2358,2021,2815,93,71,164
"11855",2345,2030,2815,78,80,158
"11856",50,2132,2815,114,117,231
"11857",1330,1233,2817,61,68,129
"11858",1357,1257,2817,60,60,120
"11859",29,2110,2822,60,55,115
"11860",28,2115,2822,59,60,119
"11861",20,2108,2822,51,53,104
"11862",45,2115,2822,76,60,136
"11863",44,2128,2822,75,73,148
"11864",4,2059,2822,35,44,79
"11865",17,2105,2822,48,50,98
"11866",209,2259,2822,175,179,354
"11867",128,2224,2822,119,129,248
"11868",23,2109,2822,54,54,108
"11869",1541,1354,2824,67,59,126
"11870",1529,1352,2824,54,57,111
"11871",1533,1354,2824,59,59,118
"11872",1530,1338,2824,56,43,99
"11873",1310,1216,2826,48,54,102
"11874",1343,1234,2826,81,72,153
"11875",1309,1211,2826,47,49,96
"11876",1318,1221,2826,56,59,115
"11877",1257,1201,2826,35,39,74
"11878",2153,2032,2830,41,37,78
"11879",2153,2035,2830,63,60,123
"11880",2146,2014,2830,56,39,95
"11881",2135,2025,2830,42,50,92
"11882",2241,2118,2830,78,73,151
"11883",2135,2017,2830,42,42,84
"11884",2234,2119,2830,101,104,205
"11885",2157,2036,2830,64,61,125
"11886",2213,2048,2830,80,73,153
"11887",1617,1426,2832,82,91,173
"11888",1529,1326,2832,32,31,63
"11889",1322,1154,2833,118,109,227
"11890",1320,1206,2833,116,121,237
"11891",2001,1839,2834,155,144,299
"11892",1926,1743,2834,115,88,203
"11893",1834,1715,2834,68,60,128
"11894",1833,1653,2834,62,38,100
"11895",2001,1821,2840,114,103,217
"11896",1851,1723,2840,44,45,89
"11897",1858,1730,2840,51,52,103
"11898",1922,1754,2840,75,76,151
"11899",1845,1711,2840,38,33,71
"11900",2020,1851,2840,133,133,266
"11901",1823,1503,2841,120,123,243
"11902",1625,1410,2844,103,70,173
"11903",1543,1354,2844,61,54,115
"11904",1311,1256,2847,31,31,62
"11905",1321,1312,2847,74,87,161
"11906",1832,1455,2852,42,40,82
"11907",2359,2035,2862,95,85,180
"11908",1539,1220,2867,94,100,194
"11909",2034,1851,2873,35,41,76
"11910",2036,1854,2873,37,44,81
"11911",2101,1924,2873,62,74,136
"11912",2032,1859,2873,33,49,82
"11913",2058,1911,2873,59,61,120
"11914",1814,1419,2874,46,44,90
"11915",2157,1752,2874,269,257,526
"11916",1828,1431,2874,60,56,116
"11917",1951,1707,2878,81,82,163
"11918",1646,1403,2880,50,48,98
"11919",1816,1537,2880,140,142,282
"11920",1515,1325,2881,41,43,84
"11921",2024,1837,2882,60,67,127
"11922",2103,1902,2882,101,92,193
"11923",2026,1831,2882,64,61,125
"11924",2028,1832,2882,66,62,128
"11925",920,808,2891,53,53,106
"11926",1724,1448,2892,70,68,138
"11927",1433,1349,2895,112,125,237
"11928",1324,1234,2895,39,46,85
"11929",1415,1311,2895,88,81,169
"11930",1345,1253,2895,60,65,125
"11931",1319,1229,2895,34,41,75
"11932",1913,1822,2902,36,37,73
"11933",2058,2003,2902,141,138,279
"11934",1951,1859,2902,74,74,148
"11935",1917,1829,2902,40,44,84
"11936",1917,1825,2902,40,40,80
"11937",1940,1852,2902,63,67,130
"11938",2150,2055,2902,193,190,383
"11939",2020,1917,2902,103,92,195
"11940",2040,1949,2907,37,44,81
"11941",2055,2002,2907,37,37,74
"11942",2144,2046,2907,101,101,202
"11943",2204,2113,2907,121,128,249
"11944",2256,2204,2907,173,179,352
"11945",1107,934,2908,38,39,77
"11946",2134,2034,2911,57,64,121
"11947",2122,1947,2911,60,32,92
"11948",2102,1959,2911,40,44,84
"11949",2054,1951,2911,32,36,68
"11950",2138,2040,2911,76,85,161
"11951",2059,1956,2911,37,41,78
"11952",1835,1650,2917,47,55,102
"11953",1948,1820,2920,88,88,176
"11954",2018,1858,2920,118,126,244
"11955",1302,1115,2921,35,40,75
"11956",1200,1038,2928,31,33,64
"11957",1725,1632,2936,31,37,68
"11958",1733,1634,2936,39,39,78
"11959",1927,1820,2936,153,145,298
"11960",39,2258,2938,158,168,326
"11961",119,2350,2938,185,207,392
"11962",2248,2105,2938,47,55,102
"11963",2327,2147,2938,86,97,183
"11964",2237,2058,2938,36,48,84
"11965",2248,2052,2938,47,42,89
"11966",2236,2100,2938,35,50,85
"11967",2357,2207,2938,116,117,233
"11968",1832,1656,2944,34,36,70
"11969",1946,1822,2944,108,122,230
"11970",1650,1507,2945,61,57,118
"11971",1655,1501,2945,66,51,117
"11972",1701,1501,2945,72,51,123
"11973",1952,1648,2948,85,58,143
"11974",1921,1638,2948,54,48,102
"11975",2121,1957,2954,49,47,96
"11976",2141,2023,2954,69,73,142
"11977",2148,2032,2954,76,82,158
"11978",2140,2023,2954,68,73,141
"11979",2226,1955,2954,119,45,164
"11980",2234,2114,2954,122,124,246
"11981",2247,2130,2954,135,140,275
"11982",1112,952,2967,52,53,105
"11983",12,2225,2976,75,80,155
"11984",3,2218,2976,62,73,135
"11985",17,2214,2976,76,69,145
"11986",2336,2154,2976,37,49,86
"11987",34,2240,2976,97,95,192
"11988",37,2255,2976,94,110,204
"11989",1629,1321,2980,32,31,63
"11990",1648,1323,2980,51,33,84
"11991",2102,2009,2984,62,69,131
"11992",2058,2001,2984,58,61,119
"11993",2052,1956,2984,52,56,108
"11994",2042,1935,2984,42,35,77
"11995",2051,1954,2984,51,54,105
"11996",2036,1935,2984,36,35,71
"11997",2046,1939,2984,46,39,85
"11998",2118,2012,2984,78,72,150
"11999",1207,1106,3000,50,56,106
"12000",1159,1045,3000,47,35,82
"12001",1156,1050,3000,39,40,79
"12002",1300,1114,3002,59,64,123
"12003",1633,1358,3004,49,48,97
"12004",1618,1342,3004,34,32,66
"12005",1729,1437,3004,105,87,192
"12006",1933,1839,3005,58,59,117
"12007",1920,1832,3005,45,52,97
"12008",2002,1901,3005,85,81,166
"12009",1929,1840,3005,54,60,114
"12010",1913,1821,3005,38,41,79
"12011",1925,1830,3005,50,50,100
"12012",1959,1900,3005,84,80,164
"12013",1535,1108,3008,83,58,141
"12014",1443,1042,3008,31,32,63
"12015",1524,1119,3008,74,69,143
"12016",1525,1112,3008,73,62,135
"12017",2309,2131,3016,104,106,210
"12018",2344,2202,3016,135,137,272
"12019",2210,2043,3016,43,58,101
"12020",2245,2104,3016,82,79,161
"12021",2232,2059,3016,65,74,139
"12022",1742,1624,3018,65,49,114
"12023",1744,1608,3018,67,33,100
"12024",2101,1723,3019,39,38,77
"12025",2306,1925,3019,158,160,318
"12026",2314,1943,3019,172,178,350
"12027",2238,1848,3019,130,123,253
"12028",2305,1941,3019,163,176,339
"12029",46,2131,3021,77,101,178
"12030",18,2044,3021,49,54,103
"12031",13,2045,3021,44,55,99
"12032",51,2047,3021,69,37,106
"12033",16,2041,3021,47,51,98
"12034",21,2056,3021,52,66,118
"12035",110,2143,3021,101,113,214
"12036",19,2051,3021,50,61,111
"12037",2237,2115,3022,77,75,152
"12038",31,2317,3022,190,197,387
"12039",2153,2038,3022,32,38,70
"12040",2152,2035,3022,32,35,67
"12041",2157,2037,3022,37,37,74
"12042",2217,2105,3022,57,65,122
"12043",2254,2134,3022,93,94,187
"12044",2025,1921,3027,73,71,144
"12045",2057,1958,3027,105,108,213
"12046",2211,2044,3027,179,154,333
"12047",1655,1522,3033,62,62,124
"12048",1634,1509,3033,41,49,90
"12049",1650,1521,3033,32,36,68
"12050",1749,1613,3033,116,113,229
"12051",1656,1528,3033,63,68,131
"12052",1654,1521,3033,61,61,122
"12053",1507,1139,3035,98,79,177
"12054",1423,1103,3035,56,43,99
"12055",1421,1112,3035,52,52,104
"12056",104,2144,3036,88,84,172
"12057",31,2106,3036,52,46,98
"12058",115,2157,3036,96,97,193
"12059",106,2138,3036,87,78,165
"12060",15,2053,3036,36,33,69
"12061",47,2131,3036,68,71,139
"12062",36,2121,3036,57,61,118
"12063",44,2121,3036,65,61,126
"12064",154,2229,3036,135,129,264
"12065",10,2057,3036,31,37,68
"12066",42,2128,3036,63,68,131
"12067",144,2223,3036,130,123,253
"12068",46,2127,3036,67,67,134
"12069",12,2052,3036,33,32,65
"12070",27,2108,3036,48,48,96
"12071",2236,2037,3038,35,37,72
"12072",2234,2036,3038,35,36,71
"12073",2329,2146,3038,90,106,196
"12074",2313,2117,3038,72,77,149
"12075",2240,2038,3038,41,38,79
"12076",2334,2137,3038,95,97,192
"12077",958,824,3040,51,54,105
"12078",1154,955,3041,35,35,70
"12079",1154,1005,3041,35,45,80
"12080",1741,1429,3043,41,44,85
"12081",1743,1429,3043,43,44,87
"12082",1813,1507,3043,73,82,155
"12083",1755,1427,3043,55,42,97
"12084",1842,1455,3043,102,70,172
"12085",1713,1344,3044,43,44,87
"12086",1725,1402,3044,55,62,117
"12087",1724,1349,3044,54,49,103
"12088",12,2107,3049,35,37,72
"12089",2241,1929,3050,43,34,77
"12090",20,2122,3050,142,147,289
"12091",27,2125,3050,149,150,299
"12092",26,2106,3050,151,131,282
"12093",2331,2028,3050,93,93,186
"12094",2323,2021,3050,85,86,171
"12095",13,2105,3050,135,130,265
"12096",945,810,3059,50,40,90
"12097",932,814,3059,37,44,81
"12098",938,824,3059,43,54,97
"12099",1216,1054,3060,44,39,83
"12100",1126,1018,3068,46,45,91
"12101",1222,1121,3068,103,106,209
"12102",2013,1614,3078,156,140,296
"12103",1850,1508,3078,68,74,142
"12104",1834,1426,3078,52,32,84
"12105",1902,1502,3078,80,68,148
"12106",1852,1455,3078,70,61,131
"12107",1123,845,3083,44,40,84
"12108",1345,1116,3083,43,51,94
"12109",1440,1245,3092,43,38,81
"12110",1528,1335,3092,85,87,172
"12111",1506,1307,3092,63,59,122
"12112",1222,849,3096,63,64,127
"12113",1025,943,3101,41,48,89
"12114",2239,2119,3105,81,84,165
"12115",2232,2116,3105,74,81,155
"12116",2252,2139,3105,94,104,198
"12117",2156,2040,3105,38,45,83
"12118",2248,2141,3105,90,106,196
"12119",2319,2158,3105,119,121,240
"12120",2201,2045,3105,43,50,93
"12121",2233,2110,3105,75,75,150
"12122",2202,2045,3105,44,50,94
"12123",2224,1754,3108,78,63,141
"12124",907,757,3114,35,32,67
"12125",1321,1151,3119,104,91,195
"12126",1403,1237,3119,151,142,293
"12127",1231,1108,3119,59,53,112
"12128",1226,1108,3119,49,48,97
"12129",1203,858,3121,91,88,179
"12130",2045,1918,3127,46,53,99
"12131",2156,2024,3127,117,119,236
"12132",2112,1951,3127,73,86,159
"12133",2224,2101,3127,145,156,301
"12134",2351,2038,3137,56,53,109
"12135",2342,2030,3137,47,45,92
"12136",2226,2123,3143,96,108,204
"12137",2214,2114,3143,82,99,181
"12138",2133,2028,3143,41,53,94
"12139",2123,2019,3143,31,44,75
"12140",2133,2033,3143,41,58,99
"12141",2259,2155,3143,125,140,265
"12142",1838,1630,3150,46,38,84
"12143",1856,1655,3150,64,63,127
"12144",1846,1629,3150,54,37,91
"12145",1833,1624,3150,41,32,73
"12146",1828,1625,3150,36,33,69
"12147",1828,1640,3150,36,48,84
"12148",1932,1715,3150,100,83,183
"12149",1405,1231,3152,47,47,94
"12150",122,2340,3154,186,210,396
"12151",2338,2157,3154,82,107,189
"12152",2339,2156,3154,83,106,189
"12153",2312,2111,3154,56,61,117
"12154",2249,2058,3154,33,48,81
"12155",2334,2131,3154,78,81,159
"12156",2259,2059,3154,43,49,92
"12157",2312,2105,3154,56,55,111
"12158",2308,2112,3154,52,62,114
"12159",1954,1617,8,74,52,126
"12160",1237,1007,686,127,144,271
"12161",1917,1615,8,37,50,87
"12162",2304,1957,8,259,267,526
"12163",35,2134,54,190,200,390
"12164",1103,836,686,33,53,86
"12165",2158,1856,8,198,211,409
"12166",2201,1906,54,36,52,88
"12167",2101,1705,1409,126,124,250
"12168",1328,1014,1590,80,70,150
"12169",1551,1218,4932,156,180,336
"12170",1355,1003,4932,40,45,85
"12171",1443,1019,4932,88,61,149
"12172",1507,1129,4932,112,131,243
"12173",27,2041,4989,203,211,414
"12174",2148,1809,4989,44,59,103
"12175",2220,1844,4989,76,94,170
"12176",2321,1942,4989,137,152,289
"12177",38,2103,4989,214,233,447
"12178",2053,1636,5202,117,95,212
"12179",2016,1634,5202,80,93,173
"12180",2026,1656,5202,90,115,205
"12181",1239,856,5372,91,101,192
"12182",1317,928,5372,129,133,262
"12183",1223,834,5372,75,79,154
"12184",1207,747,5372,59,32,91
"12185",1018,847,5386,146,147,293
"12186",1357,1225,5402,41,45,86
"12187",1648,1513,5402,212,213,425
"12188",1516,1333,5402,120,113,233
"12189",2137,2016,229,73,77,150
"12190",2303,2143,229,159,164,323
"12191",2111,2011,229,47,72,119
"12192",2105,1954,229,41,55,96
"12193",2021,1719,288,182,179,361
"12194",2157,1855,292,79,80,159
"12195",15,2113,296,115,113,228
"12196",2141,1842,292,63,67,130
"12197",1827,1524,288,68,64,132
"12198",2111,1807,292,33,32,65
"12199",2323,2033,296,63,73,136
"12200",2113,1810,292,35,35,70
"12201",1951,1650,288,152,150,302
"12202",2210,1910,292,92,95,187
"12203",36,2141,296,136,141,277
"12204",14,2107,292,216,212,428
"12205",21,2118,296,121,118,239
"12206",1130,832,294,199,202,401
"12207",1220,923,298,35,41,76
"12208",1757,1505,288,38,45,83
"12209",2112,1818,292,34,43,77
"12210",2130,2029,2870,110,119,229
"12211",2013,1908,2870,33,38,71
"12212",2035,1925,2870,55,55,110
"12213",2027,1916,2870,47,46,93
"12214",2024,1919,2870,44,49,93
"12215",2256,2157,2870,196,207,403
"12216",2030,1917,2870,50,47,97
"12217",1329,1225,2958,124,125,249
"12218",1240,1124,2958,75,64,139
"12219",1041,935,3210,51,55,106
"12220",1106,951,3210,76,71,147
"12221",1026,914,3210,36,34,70
"12222",1331,1224,3216,31,34,65
"12223",2148,2045,3328,63,70,133
"12224",2135,2031,3328,50,56,106
"12225",1916,1811,3390,186,196,382
"12226",1651,1539,3390,41,44,85
"12227",1704,1552,3390,54,57,111
"12228",1650,1535,3390,40,40,80
"12229",1744,1636,3390,94,101,195
"12230",1510,1350,3719,80,80,160
"12231",1451,1333,3719,61,63,124
"12232",1451,1356,3719,61,86,147
"12233",1440,1340,3719,50,70,120
"12234",2246,2141,3724,61,76,137
"12235",2235,2133,3724,50,68,118
"12236",2232,2113,3724,47,48,95
"12237",2227,2126,3724,42,61,103
"12238",2224,2123,3724,39,58,97
"12239",2225,2107,3724,40,42,82
"12240",1111,945,3762,96,90,186
"12241",1157,1105,3762,142,170,312
"12242",1937,1628,3786,82,48,130
"12243",1933,1657,3786,78,77,155
"12244",1452,1224,3796,57,69,126
"12245",1722,1435,3796,207,200,407
"12246",1426,1154,3796,31,39,70
"12247",1434,1150,3796,39,35,74
"12248",1454,1204,3796,59,49,108
"12249",1511,1251,3796,76,96,172
"12250",1043,811,3859,73,76,149
"12251",1043,741,3859,73,46,119
"12252",1136,757,3859,126,62,188
"12253",1047,825,3859,77,90,167
"12254",1504,1242,1137,52,72,124
"12255",1606,1310,1137,114,100,214
"12256",1528,1247,1137,76,77,153
"12257",2104,1851,1139,57,51,108
"12258",1641,1459,1147,40,47,87
"12259",1644,1451,1147,57,57,114
"12260",1621,1430,1147,38,40,78
"12261",1725,1529,1147,102,99,201
"12262",1753,1501,1147,130,71,201
"12263",1126,828,1149,44,48,92
"12264",1142,847,1149,60,67,127
"12265",2205,1830,1150,263,255,518
"12266",1900,1505,1150,78,50,128
"12267",2135,2017,1155,48,52,100
"12268",2144,2025,1155,57,60,117
"12269",2223,2108,1155,96,103,199
"12270",2126,1957,1155,39,32,71
"12271",2213,2057,1155,86,92,178
"12272",1922,1844,1156,139,129,268
"12273",1120,1011,1160,45,51,96
"12274",2322,2245,1125,74,80,154
"12275",2238,2128,1126,38,38,76
"12276",2254,2145,1126,49,55,104
"12277",2033,1701,1133,169,161,330
"12278",1818,1453,1133,34,33,67
"12279",2026,1652,1133,162,152,314
"12280",105,2359,1126,180,189,369
"12281",2240,2135,1126,35,45,80
"12282",2328,2223,1126,83,93,176
"12283",1857,1847,1193,58,72,130
"12284",1840,1827,1193,41,52,93
"12285",2042,2022,1193,163,167,330
"12286",1859,1851,1193,43,54,97
"12287",1913,1856,1193,74,81,155
"12288",1855,1830,1193,56,55,111
"12289",1819,1415,1197,123,90,213
"12290",1233,835,1131,88,75,163
"12291",1731,1539,1128,42,44,86
"12292",120,2254,1116,141,149,290
"12293",2354,2040,1117,64,70,134
"12294",13,2041,1117,83,71,154
"12295",57,2131,1117,127,121,248
"12296",2327,2011,1117,37,41,78
"12297",51,2140,1117,121,130,251
"12298",2244,2050,4455,113,125,238
"12299",1014,1002,1142,49,57,106
"12300",957,944,1142,37,39,76
"12301",1042,1021,1142,77,76,153
"12302",1004,954,1142,39,49,88
"12303",959,942,1142,39,37,76
"12304",913,847,1184,36,47,83
"12305",910,845,1184,63,70,133
"12306",1942,1856,1185,40,46,86
"12307",1954,1916,1185,52,66,118
"12308",1934,1850,1185,32,40,72
"12309",1958,1915,1185,56,65,121
"12310",2056,2018,1185,114,128,242
"12311",2023,1931,1185,81,81,162
"12312",2038,1959,1185,96,109,205
"12313",2028,1946,1185,86,96,182
"12314",2001,1917,1185,64,67,131
"12315",2145,2053,1185,163,163,326
"12316",1403,1203,1190,35,38,73
"12317",1518,1311,1190,105,106,211
"12318",1544,1355,1191,124,135,259
"12319",1449,1241,1191,69,61,130
"12320",1421,1222,1191,41,42,83
"12321",1540,1142,1176,113,92,205
"12322",1444,1102,1176,52,52,104
"12323",1528,1152,1176,96,102,198
"12324",1232,850,1176,90,85,175
"12325",2223,1839,1178,93,99,192
"12326",2127,1735,1178,37,35,72
"12327",2226,1829,1178,96,89,185
"12328",2209,1816,1178,79,76,155
"12329",2155,1747,1178,65,47,112
"12330",2141,1745,1178,56,45,101
"12331",4,2008,1178,194,188,382
"12332",2246,1853,1178,116,113,229
"12333",2235,2006,1179,63,71,134
"12334",2211,1931,1179,39,36,75
"12335",2239,1938,1179,67,43,110
"12336",2320,2048,1179,108,113,221
"12337",2207,1930,1179,35,35,70
"12338",1108,955,1180,43,50,93
"12339",1403,1247,1180,218,222,440
"12340",2107,1858,1139,60,58,118
"12341",2057,1851,1139,50,51,101
"12342",2046,1844,1139,39,44,83
"12343",2119,1907,1139,72,67,139
"12344",2114,1921,1139,67,81,148
"12345",2058,1849,1139,51,49,100
"12346",2040,1845,1139,33,45,78
"12347",2140,1944,1139,93,104,197
"12348",2138,1905,1139,91,65,156
"12349",1555,1431,1162,120,101,221
"12350",1445,1329,1162,50,39,89
"12351",1537,1431,1162,102,101,203
"12352",1949,1834,1162,79,64,143
"12353",1624,1517,1162,149,147,296
"12354",1858,1537,1166,56,42,98
"12355",1926,1609,1166,84,74,158
"12356",1927,1627,1167,85,92,177
"12357",1849,1533,1167,47,38,85
"12358",1507,1117,1168,49,47,96
"12359",1226,1057,1171,56,77,133
"12360",1225,1105,1171,55,85,140
"12361",22,2245,1172,87,100,187
"12362",1915,1823,1102,45,53,98
"12363",1931,1838,1102,54,63,117
"12364",2055,2000,1102,138,145,283
"12365",2129,1938,4455,38,53,91
"12366",2125,1937,4455,34,52,86
"12367",1644,1525,1130,36,35,71
"12368",1655,1540,1130,47,50,97
"12369",1720,1557,1130,72,67,139
"12370",1353,1004,1131,163,164,327
"12371",1545,1451,1119,71,57,128
"12372",1858,1551,1129,56,56,112
"12373",2040,1641,1129,158,106,264
"12374",1854,1556,1129,52,61,113
"12375",1926,1622,1129,84,87,171
"12376",1704,1545,1130,56,55,111
"12377",1657,1539,1130,49,49,98
"12378",1921,1818,1102,44,43,87
"12379",1922,1819,1102,45,44,89
"12380",1548,1346,1101,41,46,87
"12381",1919,1649,1101,252,229,481
"12382",1426,1318,1123,42,43,85
"12383",2143,2122,1108,35,32,67
"12384",2157,2148,1108,49,58,107
"12385",2314,2303,1108,126,133,259
"12386",2210,2154,1108,62,64,126
"12387",1307,1216,1113,39,41,80
"12388",2346,1935,1113,46,35,81
"12389",107,2112,1113,127,132,259
"12390",200,2200,1113,180,180,360
"12391",44,2048,1113,104,108,212
"12392",1706,1524,4497,46,64,110
"12393",1733,1544,4497,73,84,157
"12394",1715,1520,4497,55,60,115
"12395",1702,1512,4497,42,52,94
"12396",2152,2146,1108,44,56,100
"12397",2156,2140,1108,48,50,98
"12398",2142,2124,1108,34,34,68
"12399",2154,2145,1108,46,55,101
"12400",2145,2126,1108,37,36,73
"12401",959,745,4484,49,45,94
"12402",1650,1348,4492,46,37,83
"12403",1636,1400,4492,32,49,81
"12404",1641,1355,4492,37,44,81
"12405",1740,1437,4492,96,86,182
"12406",1024,807,5349,107,122,229
"12407",956,701,5349,79,56,135
"12408",1045,942,5800,62,42,104
"12409",1319,1009,5802,49,47,96
"12410",1321,1013,5802,51,51,102
"12411",1337,1020,5802,67,58,125
"12412",1314,957,5802,49,35,84
"12413",1332,1019,5802,62,57,119
"12414",1435,1115,5804,43,55,98
"12415",1554,1225,5804,127,125,252
"12416",1457,1104,5804,65,44,109
"12417",2329,2036,5805,277,176,453
"12418",1936,1822,5805,44,42,86
"12419",2042,1925,5805,110,105,215
"12420",1756,1419,5806,75,43,118
"12421",1801,1454,5806,82,84,166
"12422",1756,1410,5806,77,40,117
"12423",1724,1418,5806,39,42,81
"12424",1834,1507,5806,115,97,212
"12425",1713,1415,5806,32,39,71
"12426",1859,1538,5806,144,128,272
"12427",1800,1439,5806,79,63,142
"12428",1850,1541,5806,135,131,266
"12429",1739,1435,5806,54,59,113
"12430",1726,1605,5808,64,55,119
"12431",1724,1615,5808,62,65,127
"12432",1812,1655,5808,110,105,215
"12433",1701,1553,5808,39,43,82
"12434",1717,1557,5808,55,47,102
"12435",2339,2217,5810,172,172,344
"12436",2146,2028,5810,59,63,122
"12437",2205,2049,5810,78,84,162
"12438",2243,2118,5810,116,113,229
"12439",2149,2029,5810,62,64,126
"12440",2157,2037,5810,70,72,142
"12441",2157,2035,5810,70,70,140
"12442",2150,2032,5810,63,67,130
"12443",2201,2027,5810,74,62,136
"12444",2246,2118,5810,119,113,232
"12445",1245,1051,5811,37,31,68
"12446",1307,1104,5811,44,34,78
"12447",1016,917,5816,104,102,206
"12448",1114,1009,5816,162,154,316
"12449",2312,2102,5817,35,32,67
"12450",2333,2123,5817,56,53,109
"12451",2343,2130,5817,66,60,126
"12452",2349,2148,5817,72,78,150
"12453",3,2143,5817,86,73,159
"12454",50,2250,5817,133,140,273
"12455",11,2210,5817,94,100,194
"12456",2334,2129,5817,57,59,116
"12457",2329,2118,5817,52,48,100
"12458",1811,1616,5818,43,46,89
"12459",1810,1607,5818,42,37,79
"12460",1833,1624,5818,65,54,119
"12461",1759,1607,5818,31,37,68
"12462",1923,1728,5818,115,118,233
"12463",1929,1731,5818,121,121,242
"12464",1954,1805,5818,146,155,301
"12465",1832,1624,5818,64,54,118
"12466",1008,817,5820,75,47,122
"12467",32,2339,5824,119,139,258
"12468",2327,2229,5824,54,69,123
"12469",2353,2251,5824,80,91,171
"12470",1742,1452,5827,108,92,200
"12471",2337,2211,5835,60,56,116
"12472",2324,2205,5835,47,50,97
"12473",2323,2159,5835,46,44,90
"12474",2325,2209,5835,48,54,102
"12475",1846,1723,5841,39,38,77
"12476",1841,1727,5841,34,42,76
"12477",1900,1729,5841,53,44,97
"12478",1855,1733,5841,48,48,96
"12479",1944,1824,5841,97,99,196
"12480",2206,1906,256,126,96,222
"12481",1456,1344,301,47,56,103
"12482",1045,839,434,43,34,77
"12483",1033,839,434,31,34,65
"12484",1121,927,434,72,75,147
"12485",2050,1819,439,50,49,99
"12486",2145,1909,439,105,99,204
"12487",2210,1959,439,130,149,279
"12488",2114,1846,439,74,76,150
"12489",1958,1737,624,193,202,395
"12490",1607,1506,667,107,124,231
"12491",1452,1347,667,32,45,77
"12492",2127,1908,730,87,98,185
"12493",2126,1855,750,204,205,409
"12494",26,2323,774,121,148,269
"12495",22,2256,774,117,121,238
"12496",19,2316,774,114,141,255
"12497",12,2318,774,107,143,250
"12498",1555,1435,801,106,107,213
"12499",1558,1436,801,103,99,202
"12500",1513,1408,841,64,80,144
"12501",1653,1536,841,164,168,332
"12502",1506,1356,841,57,68,125
"12503",1332,1154,855,149,169,318
"12504",1159,1008,855,56,63,119
"12505",1244,1041,855,85,86,171
"12506",1258,1102,855,115,117,232
"12507",1151,1012,855,48,67,115
"12508",1147,1002,855,44,57,101
"12509",1157,1003,855,54,58,112
"12510",1228,1036,855,85,91,176
"12511",1229,1014,855,70,59,129
"12512",1911,1505,993,64,59,123
"12513",2155,1715,1978,177,110,287
"12514",1309,928,1696,148,138,286
"12515",2048,1624,1978,110,59,169
"12516",721,657,270,35,47,82
"12517",1938,1859,528,41,49,90
"12518",1956,1633,1978,58,68,126
"12519",1730,1358,1122,122,118,240
"12520",2029,1626,1978,91,61,152
"12521",1139,814,1696,58,64,122
"12522",1636,1603,269,52,58,110
"12523",2016,1943,528,79,93,172
"12524",2221,1858,959,77,83,160
"12525",1637,1455,1005,67,75,142
"12526",1615,1507,1229,45,62,107
"12527",1655,1306,376,150,131,281
"12528",1728,1420,19,108,115,223
"12529",2244,2137,230,54,62,116
"12530",1508,1410,23,38,45,83
"12531",1908,1757,125,33,37,70
"12532",39,2019,985,44,39,83
"12533",47,25,1178,197,215,412
"12534",1949,1905,3574,69,75,144
"12535",21,2123,971,41,48,89
"12536",2027,1858,1401,32,38,70
"12537",2147,2039,3818,52,59,111
"12538",1644,1544,36,44,44,88
"12539",1553,1456,664,58,56,114
"12540",1938,1507,2162,38,42,80
"12541",1611,1457,2070,56,67,123
"12542",27,2118,521,37,43,80
"12543",2146,2057,1493,76,72,148
"12544",32,2033,49,37,38,75
"12545",2231,1835,677,36,45,81
"12546",1551,1455,32,56,55,111
"12547",2244,2201,153,74,71,145
"12548",1515,1430,1191,55,60,115
"12549",2115,2025,332,40,50,90
"12550",1045,651,525,45,51,96
"12551",1130,1039,16,35,39,74
"12552",2330,2258,1178,120,128,248
"12553",2112,2031,1493,42,46,88
"12554",2202,2020,254,177,190,367
"12555",105,2119,677,190,209,399
"12556",2025,1942,43,65,72,137
"12557",1912,1741,42,102,71,173
"12558",1850,1753,44,50,53,103
"12559",1957,1905,48,57,65,122
"12560",2027,1935,50,62,65,127
"12561",2233,2113,1863,93,108,201
"12562",2042,2004,2807,47,59,106
"12563",2330,2014,45,60,69,129
"12564",2008,1915,39,103,105,208
"12565",1827,1724,295,52,44,96
"12566",2324,2232,1212,34,37,71
"12567",1659,1542,441,49,42,91
"12568",2055,1955,512,120,125,245
"12569",2107,2022,1559,62,82,144
"12570",1843,1735,352,68,85,153
"12571",2354,2252,794,34,57,91
"12572",2341,2230,267,41,50,91
"12573",1118,1008,2873,58,68,126
"12574",16,2159,2525,56,64,120
"12575",1905,1801,213,75,76,151
"12576",1938,1846,316,38,51,89
"12577",1915,1800,125,40,40,80
"12578",1958,1859,41,43,54,97
"12579",1843,1756,465,58,61,119
"12580",1930,1847,3574,50,57,107
"12581",2001,1802,2904,36,42,78
"12582",2051,1751,37,41,46,87
"12583",1003,725,1512,38,48,86
"12584",1747,1441,1675,67,71,138
"12585",1944,1641,8,40,51,91
"12586",1600,1217,4932,165,179,344
"12587",1526,1138,4932,131,140,271
"12588",1540,1203,4932,145,165,310
"12589",2304,1925,4989,120,135,255
"12590",2213,1820,4989,69,70,139
"12591",2211,1831,4989,67,81,148
"12592",2201,1819,4989,57,69,126
"12593",1328,953,5135,130,148,278
"12594",1249,900,5135,91,95,186
"12595",2147,1811,5136,43,61,104
"12596",1401,1229,5194,50,54,104
"12597",2212,2050,5195,250,270,520
"12598",1139,751,5372,31,36,67
"12599",1144,757,5372,36,42,78
"12600",1432,1031,5386,77,71,148
"12601",1348,1214,5402,32,34,66
"12602",1447,1318,5402,91,98,189
"12603",1352,1220,5402,36,40,76
"12604",1425,1251,5402,69,71,140
"12605",2132,2021,229,68,82,150
"12606",2118,2008,229,54,69,123
"12607",2351,2042,296,91,82,173
"12608",1614,1314,286,87,90,177
"12609",2158,1904,292,80,89,169
"12610",1802,1506,288,57,57,114
"12611",1854,1601,288,95,101,196
"12612",1331,1007,298,106,85,191
"12613",2028,1905,2870,48,35,83
"12614",2032,1925,2870,52,55,107
"12615",2242,2120,2870,182,170,352
"12616",2134,2033,2870,114,123,237
"12617",1300,1151,2958,95,91,186
"12618",1034,920,3210,44,40,84
"12619",1024,922,3210,34,42,76
"12620",1043,934,3210,53,54,107
"12621",1352,1231,3216,52,41,93
"12622",1332,1226,3216,32,36,68
"12623",1356,1249,3216,56,59,115
"12624",834,723,3265,89,83,172
"12625",2237,2140,3328,112,125,237
"12626",2319,2210,3328,154,155,309
"12627",2119,2011,3328,34,36,70
"12628",2121,2013,3328,36,38,74
"12629",2133,2009,3328,53,34,87
"12630",2324,2107,3717,84,107,191
"12631",2145,1857,3717,45,32,77
"12632",2240,1955,3717,100,90,190
"12633",2150,1920,3717,50,55,105
"12634",1444,1324,3719,54,54,108
"12635",1422,1321,3719,32,51,83
"12636",1452,1345,3719,62,75,137
"12637",2335,2149,3724,110,84,194
"12638",2231,2123,3724,46,58,104
"12639",2234,2134,3724,49,69,118
"12640",2356,2246,3724,116,136,252
"12641",1017,855,3762,42,40,82
"12642",1851,1633,3786,36,53,89
"12643",1923,1651,3786,68,71,139
"12644",2135,1817,3786,185,147,332
"12645",1511,1215,3796,76,60,136
"12646",1429,1206,3796,34,51,85
"12647",1109,844,3859,99,109,208
"12648",1225,833,3859,175,98,273
"12649",1014,752,3859,54,67,121
"12650",1907,1754,2918,62,74,136
"12651",1249,1118,9,49,58,107
"12652",2004,1821,254,59,71,130
"12653",1425,1336,1283,65,71,136
"12654",36,2328,794,61,88,149
"12655",2059,2002,316,119,127,246
"12656",2346,2301,1039,86,101,187
"12657",37,2321,1374,117,121,238
"12658",2134,2056,1493,64,71,135
"12659",1951,1633,3486,81,88,169
"12660",2322,2237,55,57,72,129
"12661",1944,1856,40,164,176,340
"12662",1941,1457,544,41,32,73
"12663",1443,1354,1283,83,89,172
"12664",7,2100,291,52,70,122
"12665",2252,2230,1178,67,95,162
"12666",2111,2015,332,36,40,76
"12667",2058,2006,52,63,66,129
"12668",1658,1256,625,68,71,139
"12669",1606,1514,32,71,74,145
"12670",2200,2037,1863,60,72,132
"12671",1819,1653,33,39,53,92
"12672",2044,2001,2807,49,56,105
"12673",1946,1533,544,46,68,114
"12674",1842,1749,295,67,69,136
"12675",1355,1306,1283,35,41,76
"12676",1020,908,201,55,68,123
"12677",2213,2026,164,43,46,89
"12678",1635,1546,36,35,46,81
"12679",2356,2052,291,41,62,103
"12680",1507,1408,23,37,43,80
"12681",1452,1405,1191,32,35,67
"12682",2305,1900,677,55,65,120
"12683",18,2111,291,63,81,144
"12684",1848,1758,213,58,73,131
"12685",2226,2049,3955,61,59,120
"12686",1911,1827,1454,56,62,118
"12687",2024,1931,552,84,91,175
"12688",2129,2037,3005,94,97,191
"12689",1914,1830,248,44,50,94
"12690",2330,2240,2884,140,145,285
"12691",2314,2225,2165,119,135,254
"12692",1639,1529,102,34,39,73
"12693",1923,1813,2606,53,63,116
"12694",2330,2148,1376,250,263,513
"12695",1437,1340,1347,82,95,177
"12696",2233,2140,2030,203,220,423
"12697",1835,1754,1754,50,54,104
"12698",2228,2145,1959,98,115,213
"12699",110,2121,47,80,106,186
"12700",1923,1508,1687,83,68,151
"12701",1527,1425,30,57,55,112
"12702",1850,1749,44,50,49,99
"12703",1920,1820,46,50,50,100
"12704",2040,1943,52,40,43,83
"12705",5,2321,56,175,201,376
"12706",1601,1504,1383,66,64,130
"12707",2116,2003,417,96,113,209
"12708",1840,1754,1300,50,54,104
"12709",2148,1727,2347,143,147,290
"12710",1555,1115,2795,85,75,160
"12711",1802,1508,2191,72,43,115
"12712",1815,1654,2908,40,34,74
"12713",1950,1510,23,120,100,220
"12714",2218,2136,263,58,71,129
"12715",2348,2222,879,73,102,175
"12716",1430,1335,28,35,35,70
"12717",1731,1636,38,61,66,127
"12718",2150,2057,48,170,177,347
"12719",2142,2055,56,32,55,87
"12720",2226,1746,2347,181,166,347
"12721",2123,2033,2076,33,53,86
"12722",2101,1954,1272,41,64,105
"12723",1911,1800,1926,51,60,111
"12724",1838,1737,37,43,42,85
"12725",931,831,2177,31,31,62
"12726",1828,1716,2908,53,56,109
"12727",1938,1525,23,108,115,223
"12728",2044,2000,1080,174,180,354
"12729",1823,1707,1665,58,67,125
"12730",1755,1703,243,40,43,83
"12731",2036,1600,2347,71,60,131
"12732",1911,1804,1926,51,64,115
"12733",2237,2154,263,77,89,166
"12734",2209,2020,1390,44,70,114
"12735",38,2143,1771,53,63,116
"12736",1825,1705,1665,60,65,125
"12737",1843,1803,243,88,103,191
"12738",2109,2015,52,69,75,144
"12739",2306,2013,43,81,103,184
"12740",1937,1840,32,282,280,562
"12741",1810,1701,42,40,31,71
"12742",1905,1828,1300,75,88,163
"12743",2006,1535,2347,41,35,76
"12744",2122,2032,2076,32,52,84
"12745",2015,1925,794,35,50,85
"12746",2052,1835,1186,37,45,82
"12747",1716,1609,2210,51,44,95
"12748",1657,1601,1021,57,51,108
"12749",2211,2020,1390,46,70,116
"12750",59,2041,47,69,66,135
"12751",1609,1527,27,54,62,116
"12752",2118,2035,49,33,40,73
"12753",1755,1647,40,55,47,102
"12754",1837,1747,44,37,47,84
"12755",1028,933,2320,33,43,76
"12756",2038,1925,2908,183,185,368
"12757",2125,1636,23,215,186,401
"12758",1712,1605,611,202,185,387
"12759",2027,1848,425,42,68,110
"12760",2004,1915,1120,34,50,84
"12761",2322,2011,3034,32,31,63
"12762",1838,1742,2309,33,52,85
"12763",1917,1449,1687,77,49,126
"12764",1843,1712,35,38,42,80
"12765",2213,1750,2347,168,170,338
"12766",2320,2211,3309,80,91,171
"12767",2234,2139,837,49,59,108
"12768",1145,1032,5,70,72,142
"12769",1908,1728,35,63,58,121
"12770",1819,1743,1754,34,43,77
"12771",1849,1800,42,79,90,169
"12772",2011,1535,2347,46,35,81
"12773",2343,2254,55,68,89,157
"12774",1921,1832,1599,86,92,178
"12775",1841,1742,37,46,47,93
"12776",1830,1720,2908,55,60,115
"12777",27,2013,47,37,38,75
"12778",2216,2119,56,66,79,145
"12779",2207,2116,263,47,51,98
"12780",1827,1628,355,32,33,65
"12781",1800,1640,1665,35,40,75
"12782",1827,1748,1754,42,48,90
"12783",1249,1158,15,39,38,77
"12784",1806,1710,243,51,50,101
"12785",1611,1504,32,76,64,140
"12786",1926,1835,46,56,65,121
"12787",2040,1947,52,40,47,87
"12788",2254,2206,56,104,126,230
"12789",2247,1827,2347,202,207,409
"12790",1619,1154,2795,109,114,223
"12791",1640,1304,3513,135,124,259
"12792",1201,1101,9,41,36,77
"12793",2351,2243,3309,111,123,234
"12794",1804,1655,113,39,55,94
"12795",2109,1953,1272,49,63,112
"12796",2355,2049,39,170,199,369
"12797",40,2133,51,35,53,88
"12798",1704,1348,1741,39,43,82
"12799",2112,1855,1186,57,65,122
"12800",2227,2006,2170,32,46,78
"12801",1756,1638,1305,171,168,339
"12802",1306,1157,2068,31,37,68
"12803",1349,1256,1759,49,71,120
"12804",1655,1608,1021,55,58,113
"12805",46,2149,1771,61,69,130
"12806",1823,1738,1754,38,38,76
"12807",2148,2104,1959,58,74,132
"12808",2310,2129,879,35,49,84
"12809",1214,814,3579,74,79,153
"12810",1550,1456,32,55,56,111
"12811",1607,1512,34,37,42,79
"12812",1741,1651,40,41,51,92
"12813",1940,1851,48,40,51,91
"12814",2341,2023,45,61,78,139
"12815",1946,1854,1599,111,114,225
"12816",1601,1456,913,76,96,172
"12817",1924,1811,1926,64,71,135
"12818",1701,1602,2210,36,37,73
"12819",2220,2028,1390,55,78,133
"12820",1759,1641,1665,34,41,75
"12821",1216,902,1683,31,37,68
"12822",2252,2212,49,127,137,264
"12823",1326,1234,20,91,94,185
"12824",2002,1910,48,62,70,132
"12825",1527,1435,1383,32,35,67
"12826",1731,1508,2191,41,43,84
"12827",2218,2024,1390,53,74,127
"12828",1920,1829,492,55,69,124
"12829",2251,2213,1959,121,143,264
"12830",1647,1607,2363,42,47,89
"12831",36,2308,879,121,148,269
"12832",53,2055,47,63,80,143
"12833",2203,2118,49,78,83,161
"12834",2144,2028,1272,84,98,182
"12835",101,2246,2170,186,206,392
"12836",1816,1530,2191,86,65,151
"12837",1651,1502,2112,121,132,253
"12838",1529,1501,2288,74,86,160
"12839",2158,2002,1390,33,52,85
"12840",2015,1900,417,35,50,85
"12841",2105,1646,2347,100,106,206
"12842",1626,1533,3254,46,48,94
"12843",2246,2137,3309,46,57,103
"12844",2110,1947,1272,50,57,107
"12845",2222,2123,837,37,43,80
"12846",2159,2116,263,39,51,90
"12847",2020,1713,2008,38,43,81
"12848",2351,2251,2009,89,96,185
"12849",1819,1507,2010,92,92,184
"12850",1857,1742,2025,162,147,309
"12851",32,2048,2027,97,88,185
"12852",5,2029,2027,70,69,139
"12853",19,2033,2027,84,73,157
"12854",1430,1124,2036,71,79,150
"12855",1404,1040,2036,52,35,87
"12856",2328,2156,2042,99,101,200
"12857",2153,1834,2044,51,64,115
"12858",2204,1816,2044,60,46,106
"12859",1554,1443,2048,45,53,98
"12860",1558,1434,2048,49,44,93
"12861",2349,2000,2050,67,70,137
"12862",2332,1925,2050,50,35,85
"12863",1118,1021,2058,36,34,70
"12864",1305,1201,2082,37,31,68
"12865",1728,1352,2105,61,57,118
"12866",1734,1352,2105,52,37,89
"12867",1957,1613,2105,188,178,366
"12868",2023,1630,2109,141,95,236
"12869",2255,2057,2112,40,47,87
"12870",11,2021,2120,90,91,181
"12871",2219,2041,2121,50,51,101
"12872",2052,1739,2122,133,109,242
"12873",2335,2239,2127,98,94,192
"12874",2233,2141,2127,36,36,72
"12875",2330,2238,2131,71,83,154
"12876",2336,2248,2131,81,88,169
"12877",1031,919,2132,81,89,170
"12878",1925,1652,2133,36,42,78
"12879",1932,1655,2133,43,45,88
"12880",2344,2244,2146,83,89,172
"12881",9,2211,2146,49,56,105
"12882",1727,1520,2147,37,40,77
"12883",1434,1337,2156,37,42,79
"12884",1510,1339,2159,50,49,99
"12885",1800,1440,2162,59,55,114
"12886",2133,2008,2164,54,53,107
"12887",2128,2009,2164,49,54,103
"12888",2142,2021,2164,63,66,129
"12889",25,2234,2167,88,89,177
"12890",15,2033,2171,86,93,179
"12891",2342,1952,2171,45,52,97
"12892",2342,1958,2171,45,58,103
"12893",15,2028,2171,78,88,166
"12894",2336,1955,2171,44,55,99
"12895",1318,959,2172,131,132,263
"12896",2318,2136,2172,73,81,154
"12897",2247,2104,2172,42,49,91
"12898",1519,1344,2174,46,39,85
"12899",2152,2027,2176,55,62,117
"12900",2326,2235,2194,65,70,135
"12901",2259,2213,2194,38,48,86
"12902",1817,1459,2198,39,44,83
"12903",1332,1215,2200,34,35,69
"12904",1330,1212,2200,32,32,64
"12905",1334,1220,2200,35,35,70
"12906",1604,1405,2201,47,55,102
"12907",1105,934,2206,40,44,84
"12908",44,2346,2210,141,151,292
"12909",1915,1809,2212,45,39,84
"12910",14,2024,2215,93,94,187
"12911",2125,1931,2216,83,36,119
"12912",1425,1323,2223,38,33,71
"12913",25,2337,2227,136,137,273
"12914",1159,813,2240,65,58,123
"12915",1506,1230,2242,51,45,96
"12916",1332,1210,2253,42,40,82
"12917",2256,2117,2254,87,87,174
"12918",1201,1002,2257,49,42,91
"12919",2106,1929,2259,80,39,119
"12920",2032,1941,2259,46,51,97
"12921",2250,2202,2261,33,37,70
"12922",2341,2246,2261,84,81,165
"12923",2312,2221,2261,55,56,111
"12924",1817,1432,2268,83,72,155
"12925",1607,1245,2272,68,60,128
"12926",1728,1518,2274,49,33,82
"12927",1754,1603,2274,75,78,153
"12928",2124,1752,2276,72,62,134
"12929",2130,1747,2276,80,59,139
"12930",1311,1202,2277,44,37,81
"12931",1303,1200,2277,36,35,71
"12932",1920,1717,2278,103,107,210
"12933",1814,1611,2278,40,46,86
"12934",2255,2130,2280,82,89,171
"12935",2209,2042,2280,42,42,84
"12936",1203,1120,2283,33,40,73
"12937",2348,2035,2288,47,50,97
"12938",26,2100,2288,45,40,85
"12939",121,2203,2288,100,103,203
"12940",50,2130,2288,69,70,139
"12941",2339,2024,2288,32,34,66
"12942",35,2105,2288,88,80,168
"12943",2400,2036,2288,53,46,99
"12944",1831,1647,2292,42,42,84
"12945",1855,1721,2292,66,76,142
"12946",1605,1506,2294,34,35,69
"12947",1645,1418,2294,66,68,134
"12948",1519,1425,2296,218,218,436
"12949",2151,2002,2297,65,47,112
"12950",2129,2002,2297,43,47,90
"12951",2137,2021,2297,51,66,117
"12952",2001,1636,2298,77,71,148
"12953",1931,1614,2298,46,49,95
"12954",2312,1958,2299,50,68,118
"12955",31,2108,2299,129,138,267
"12956",2310,2209,2306,49,54,103
"12957",1755,1615,2308,86,55,141
"12958",1734,1622,2308,38,35,73
"12959",1749,1631,2308,77,66,143
"12960",1858,1734,2311,56,54,110
"12961",1259,931,2321,90,76,166
"12962",1906,1558,2334,111,113,224
"12963",2243,1940,2335,182,190,372
"12964",1623,1444,2336,33,31,64
"12965",1921,1755,2337,74,70,144
"12966",1428,1112,2340,41,47,88
"12967",1054,956,2342,49,56,105
"12968",1044,942,2342,42,42,84
"12969",7,2048,2344,60,78,138
"12970",1927,1735,2346,93,90,183
"12971",2004,1804,2346,131,119,250
"12972",1344,1145,2348,42,35,77
"12973",2359,2322,2349,110,122,232
"12974",2244,2206,2349,34,46,80
"12975",2251,2208,2349,37,48,85
"12976",2317,2216,2357,54,61,115
"12977",2049,1914,2376,64,69,133
"12978",2106,1926,2376,79,79,158
"12979",2300,2112,2376,195,187,382
"12980",2134,2035,2377,60,75,135
"12981",33,2346,2378,139,146,285
"12982",1744,1437,2380,33,38,71
"12983",1750,1444,2380,70,69,139
"12984",2334,2127,2385,37,37,74
"12985",1417,1040,2386,43,35,78
"12986",1836,1707,2387,41,42,83
"12987",1848,1718,2387,53,53,106
"12988",1754,1435,2390,90,85,175
"12989",2123,2012,2393,32,37,69
"12990",2224,2107,2393,82,81,163
"12991",2238,2124,2393,107,109,216
"12992",1220,1044,2394,38,39,77
"12993",2049,1901,2400,45,41,86
"12994",2107,1929,2400,63,69,132
"12995",2340,2211,2404,51,51,102
"12996",1821,1513,2405,66,68,134
"12997",1827,1524,2405,68,79,147
"12998",1823,1447,2405,54,32,86
"12999",1826,1517,2405,57,62,119
"13000",1052,930,2408,33,31,64
"13001",2142,2052,2418,85,92,177
"13002",2115,2034,2418,59,74,133
"13003",2249,2030,2419,44,35,79
"13004",2301,2044,2419,56,49,105
"13005",1700,1333,2422,176,168,344
"13006",1154,1119,2423,35,49,84
"13007",1300,1216,2423,101,106,207
"13008",1945,1842,2425,31,37,68
"13009",1957,1855,2425,42,50,92
"13010",1641,1523,2427,60,68,128
"13011",1625,1450,2427,44,35,79
"13012",1354,1240,2429,71,75,146
"13013",1346,1231,2429,63,66,129
"13014",1331,1217,2429,37,37,74
"13015",1257,1133,2434,83,88,171
"13016",1232,1044,2434,57,39,96
"13017",1534,1225,2435,260,260,520
"13018",1151,851,2435,37,41,78
"13019",1227,915,2435,70,65,135
"13020",1927,1801,2438,70,71,141
"13021",1859,1723,2438,42,33,75
"13022",1722,1630,2442,43,45,88
"13023",1840,1728,2446,31,38,69
"13024",1612,1525,2451,41,50,91
"13025",2340,2037,2459,74,77,151
"13026",1258,1133,2461,91,78,169
"13027",2028,1932,2462,42,42,84
"13028",1839,1725,2465,94,105,199
"13029",1854,1541,2472,71,66,137
"13030",2005,1749,2474,153,134,287
"13031",1807,1616,2474,35,41,76
"13032",2023,1817,2474,176,162,338
"13033",1752,1545,2479,65,65,130
"13034",1715,1501,2479,55,51,106
"13035",2135,2031,2481,65,61,126
"13036",2148,2056,2481,75,81,156
"13037",1253,1137,2482,71,77,148
"13038",1316,1205,2482,94,105,199
"13039",2028,1706,2488,31,36,67
"13040",2035,1717,2488,36,42,78
"13041",2112,1649,2492,108,66,174
"13042",1955,1615,2492,36,35,71
"13043",2135,1734,2492,136,114,250
"13044",2042,1702,2492,86,82,168
"13045",36,2257,2493,100,97,197
"13046",2359,2154,2493,62,34,96
"13047",2112,2006,2494,38,46,84
"13048",1024,847,2495,90,92,182
"13049",1901,1633,2497,97,48,145
"13050",1258,1210,2501,41,40,81
"13051",1450,1109,2504,39,39,78
"13052",1936,1743,2509,108,108,216
"13053",2357,2258,2515,94,98,192
"13054",2341,2234,2515,78,74,152
"13055",2335,2236,2515,72,76,148
"13056",200,113,2515,226,233,459
"13057",1516,1352,2516,56,57,113
"13058",1502,1144,2520,52,52,104
"13059",6,2309,2521,106,109,215
"13060",2348,2251,2521,88,91,179
"13061",1048,927,2525,134,132,266
"13062",912,804,2525,45,49,94
"13063",2033,1842,2534,69,72,141
"13064",2053,1855,2534,89,85,174
"13065",2026,1841,2534,62,71,133
"13066",2338,2027,2547,44,42,86
"13067",34,2128,2547,100,103,203
"13068",9,2053,2547,75,68,143
"13069",38,2242,2548,101,112,213
"13070",1448,1254,2554,51,47,98
"13071",51,2130,2557,95,95,190
"13072",32,2121,2557,76,86,162
"13073",1842,1714,2558,48,59,107
"13074",2050,1849,2558,73,54,127
"13075",1845,1710,2558,51,55,106
"13076",123,6,2558,182,171,353
"13077",1925,1829,2562,50,54,104
"13078",1915,1817,2562,40,42,82
"13079",1912,1821,2562,37,46,83
"13080",2047,1907,2563,70,72,142
"13081",1344,1209,2564,45,44,89
"13082",1944,1624,2572,140,144,284
"13083",1739,1423,2572,32,38,70
"13084",1742,1421,2572,35,36,71
"13085",1752,1418,2572,48,33,81
"13086",1828,1504,2577,86,79,165
"13087",1645,1538,2581,81,68,149
"13088",1713,1614,2581,106,104,210
"13089",1601,1509,2581,39,44,83
"13090",1731,1411,2584,34,31,65
"13091",1916,1550,2584,139,130,269
"13092",1712,1555,2585,40,38,78
"13093",1149,844,2586,35,47,82
"13094",1841,1510,2587,86,80,166
"13095",1950,1753,2589,194,170,364
"13096",1751,1622,2589,105,107,212
"13097",103,2158,2597,116,128,244
"13098",2338,2021,2597,31,31,62
"13099",44,2128,2597,97,98,195
"13100",2348,2046,2597,54,71,125
"13101",2004,1810,2598,34,35,69
"13102",1144,810,2612,62,45,107
"13103",1735,1629,2625,65,64,129
"13104",1712,1612,2625,39,42,81
"13105",1702,1352,2629,34,37,71
"13106",1615,1517,2631,45,42,87
"13107",1520,1155,2652,70,70,140
"13108",1015,847,2674,88,87,175
"13109",1953,1849,2675,74,74,148
"13110",2015,1906,2675,96,91,187
"13111",1943,1834,2675,64,59,123
"13112",2245,2155,2692,36,40,76
"13113",1836,1703,2695,50,59,109
"13114",1845,1710,2695,65,65,130
"13115",1824,1708,2705,46,40,86
"13116",1424,1318,2712,79,74,153
"13117",1749,1438,2715,56,63,119
"13118",933,819,2723,36,44,80
"13119",1636,1440,2724,79,90,169
"13120",2306,2043,2726,59,48,107
"13121",2249,1945,2728,197,195,392
"13122",2021,1714,2728,47,44,91
"13123",1651,1540,2729,87,85,172
"13124",1723,1513,2729,119,58,177
"13125",2024,1928,2731,32,33,65
"13126",2103,2015,2731,71,80,151
"13127",1957,1840,2748,90,95,185
"13128",1930,1751,2748,63,46,109
"13129",1233,1053,2750,31,38,69
"13130",1637,1554,2755,34,39,73
"13131",1638,1553,2755,35,38,73
"13132",1642,1551,2755,39,36,75
"13133",1641,1547,2755,38,32,70
"13134",1542,1401,2757,60,61,121
"13135",2208,2034,2759,143,149,292
"13136",2100,1922,2759,75,77,152
"13137",2034,1901,2759,49,56,105
"13138",2032,1854,2759,47,49,96
"13139",2113,1929,2759,96,89,185
"13140",1711,1559,2778,40,46,86
"13141",1721,1559,2778,43,39,82
"13142",2319,2017,2782,34,36,70
"13143",2030,1910,2784,138,150,288
"13144",1704,1349,2791,32,34,66
"13145",1059,936,2792,36,36,72
"13146",2233,2106,2800,91,96,187
"13147",2213,2050,2800,47,47,94
"13148",1431,1112,2802,31,37,68
"13149",2332,2245,2803,95,100,195
"13150",928,845,2805,43,52,95
"13151",1827,1736,2809,107,116,223
"13152",1738,1650,2809,66,75,141
"13153",1504,1345,2811,54,55,109
"13154",100,2140,2815,128,125,253
"13155",2325,2011,2815,33,36,69
"13156",126,2224,2815,150,169,319
"13157",49,2144,2822,80,89,169
"13158",17,2051,2822,61,44,105
"13159",1337,1244,2826,75,82,157
"13160",2202,2053,2830,49,58,107
"13161",1221,1054,2833,57,49,106
"13162",1912,1746,2840,65,68,133
"13163",1927,1756,2840,80,78,158
"13164",1845,1715,2840,38,37,75
"13165",1705,1340,2841,42,40,82
"13166",1946,1811,2846,42,41,83
"13167",2012,1845,2846,73,75,148
"13168",1240,1217,2847,33,32,65
"13169",2205,2030,2873,126,140,266
"13170",2043,1906,2873,44,56,100
"13171",1642,1350,2880,46,35,81
"13172",1801,1510,2880,111,99,210
"13173",2007,1815,2882,45,45,90
"13174",2027,1837,2882,63,67,130
"13175",1903,1458,2889,108,93,201
"13176",1938,1848,2902,61,63,124
"13177",2034,1942,2907,31,37,68
"13178",2049,1939,2907,44,34,78
"13179",1111,936,2908,42,41,83
"13180",1949,1820,2920,95,88,183
"13181",1330,1141,2922,136,141,277
"13182",1321,1200,2928,119,115,234
"13183",1252,1129,2928,78,79,157
"13184",1744,1656,2936,55,61,116
"13185",1735,1640,2936,41,45,86
"13186",2353,2206,2938,112,116,228
"13187",2256,2118,2938,43,58,101
"13188",2257,2114,2938,56,64,120
"13189",1906,1639,2948,39,49,88
"13190",2106,1943,2954,34,33,67
"13191",2104,1944,2954,32,34,66
"13192",22,2238,2976,81,93,174
"13193",1853,1541,2980,176,171,347
"13194",2112,2008,2984,72,68,140
"13195",2122,2028,2984,66,72,138
"13196",2049,1944,2984,49,44,93
"13197",1330,1213,2996,108,123,231
"13198",1254,1134,3000,59,39,98
"13199",2342,2030,3004,47,40,87
"13200",12,2106,3004,77,76,153
"13201",2322,2017,3004,47,42,89
"13202",1516,1115,3008,64,65,129
"13203",123,22,3009,183,187,370
"13204",1809,1459,3010,83,84,167
"13205",2224,2051,3016,59,66,125
"13206",2230,2037,3016,65,52,117
"13207",2216,2043,3016,49,58,107
"13208",2232,2103,3016,67,78,145
"13209",1715,1615,3018,34,36,70
"13210",1733,1628,3018,48,45,93
"13211",23,2043,3021,54,53,107
"13212",103,2134,3021,94,104,198
"13213",24,2102,3021,55,72,127
"13214",43,2111,3021,49,56,105
"13215",2206,2044,3022,42,44,86
"13216",2152,2038,3022,32,38,70
"13217",2013,1713,3022,71,73,144
"13218",2118,1810,3022,136,130,266
"13219",1631,1518,3024,57,43,100
"13220",1619,1519,3025,32,34,66
"13221",1,2032,3027,61,60,121
"13222",2350,2007,3027,46,37,83
"13223",17,2034,3027,73,64,137
"13224",2351,2012,3027,47,42,89
"13225",1554,1142,3028,102,92,194
"13226",1736,1559,3033,103,99,202
"13227",2201,2025,3033,32,35,67
"13228",12,2054,3036,36,34,70
"13229",44,2128,3036,65,68,133
"13230",26,2104,3036,50,44,94
"13231",2312,2111,3038,75,71,146
"13232",2257,2102,3038,60,62,122
"13233",113,2325,3038,203,210,413
"13234",2331,2018,3039,46,48,94
"13235",39,2113,3039,114,103,217
"13236",1325,1238,3039,44,53,97
"13237",1218,1026,3041,61,66,127
"13238",2208,2029,3042,52,54,106
"13239",2204,2024,3042,48,49,97
"13240",2033,1730,3042,66,65,131
"13241",1854,1536,3046,50,41,91
"13242",2141,1743,3046,217,168,385
"13243",2217,2114,3049,115,114,229
"13244",2323,2231,3049,181,191,372
"13245",2306,2004,3050,68,69,137
"13246",2325,2022,3050,87,87,174
"13247",142,2239,3050,224,224,448
"13248",2245,1942,3050,47,47,94
"13249",2309,1957,3050,49,37,86
"13250",2343,2040,3050,83,80,163
"13251",1543,1226,3052,89,91,180
"13252",1046,915,3059,101,90,191
"13253",1214,1056,3060,40,41,81
"13254",1330,1236,3061,63,71,134
"13255",1614,1507,3068,55,47,102
"13256",1615,1518,3068,56,58,114
"13257",1126,1027,3068,46,54,100
"13258",1450,1133,3072,32,33,65
"13259",1850,1504,3078,68,70,138
"13260",1815,1429,3078,33,35,68
"13261",1900,1515,3078,83,81,164
"13262",1918,1525,3078,121,115,236
"13263",1125,1000,3079,61,55,116
"13264",1726,1633,3084,52,58,110
"13265",1542,1216,3090,82,83,165
"13266",1448,1255,3092,45,47,92
"13267",1439,1245,3092,36,37,73
"13268",1435,1245,3092,32,37,69
"13269",1630,1521,3097,31,41,72
"13270",1952,1856,3098,40,46,86
"13271",2314,2202,3105,116,127,243
"13272",2152,2040,3105,34,45,79
"13273",2237,2129,3105,79,94,173
"13274",2156,2014,3112,48,44,92
"13275",1516,1402,3120,66,67,133
"13276",2100,1923,3127,61,58,119
"13277",2241,2118,3127,162,173,335
"13278",2338,2031,3137,38,41,79
"13279",8,2100,3137,73,75,148
"13280",1333,1204,3152,33,39,72
"13281",2249,2056,3154,33,46,79
"13282",1,2210,3154,105,120,225
"13283",2315,2118,3154,59,68,127
"13284",2249,2043,3154,33,33,66
"13285",2250,2053,3154,34,43,77
"13286",1213,1053,1171,43,73,116
"13287",2000,1924,1185,58,74,132
"13288",2040,2000,1185,98,110,208
"13289",2039,1956,1185,97,106,203
"13290",1423,1226,1190,55,61,116
"13291",1420,1222,1190,52,57,109
"13292",1449,1239,1190,76,74,150
"13293",1507,1316,1191,87,96,183
"13294",1456,1301,1191,76,81,157
"13295",1834,1811,1193,35,36,71
"13296",1853,1836,1193,37,39,76
"13297",1831,1816,1193,32,41,73
"13298",1656,1326,1197,40,41,81
"13299",1741,1413,1197,85,88,173
"13300",1647,1320,1197,31,35,66
"13301",32,2351,2015,48,51,99
"13302",14,2320,2016,125,145,270
"13303",2256,2156,2016,47,61,108
"13304",2137,2022,1155,50,57,107
"13305",2128,2015,1155,41,50,91
"13306",2129,2025,1155,42,60,102
"13307",1843,1811,1156,100,101,201
"13308",1824,1458,1150,42,43,85
"13309",1836,1506,1150,54,51,105
"13310",1135,1048,1151,108,108,216
"13311",1034,947,5800,51,47,98
"13312",1019,936,5800,35,36,71
"13313",1331,959,5804,168,159,327
"13314",1537,1213,5804,105,113,218
"13315",1227,851,5804,104,91,195
"13316",1637,1615,1164,85,85,170
"13317",1907,1810,1162,37,40,77
"13318",1512,1401,1162,77,71,148
"13319",1737,1720,1156,34,50,84
"13320",1746,1718,1156,43,48,91
"13321",2207,1934,1179,35,39,74
"13322",924,655,5349,62,65,127
"13323",1432,1042,1176,40,32,72
"13324",2340,2234,1172,45,89,134
"13325",1729,1535,2019,87,83,170
"13326",1541,1340,2019,32,40,72
"13327",1917,1548,2021,95,93,188
"13328",2127,1958,5804,155,138,293
"13329",2110,1959,5804,138,139,277
"13330",2208,1840,5805,77,55,132
"13331",1958,1841,5805,66,61,127
"13332",2100,1926,5805,128,106,234
"13333",1626,1427,1147,43,37,80
"13334",1832,1456,1150,50,41,91
"13335",1916,1809,1102,39,34,73
"13336",2123,1917,4455,32,32,64
"13337",2152,1931,4455,61,46,107
"13338",2148,2000,4455,57,75,132
"13339",2200,1933,1139,113,93,206
"13340",2237,2037,1139,150,157,307
"13341",1559,1316,1137,112,106,218
"13342",2331,2231,1126,86,101,187
"13343",17,2313,1126,132,143,275
"13344",2356,2209,1128,69,69,138
"13345",1659,1521,1130,51,31,82
"13346",1142,755,1131,32,35,67
"13347",2251,2147,1126,46,57,103
"13348",10,1948,1113,70,48,118
"13349",2356,1944,1113,56,44,100
"13350",2352,2041,1117,62,71,133
"13351",1956,1546,1118,151,123,274
"13352",1907,1806,2039,32,36,68
"13353",2015,1903,2039,100,93,193
"13354",1933,1816,2039,58,46,104
"13355",2331,2227,2043,85,97,182
"13356",32,2332,2043,146,162,308
"13357",1509,1412,2044,82,87,169
"13358",2336,1933,2047,37,33,70
"13359",4,2007,2047,65,67,132
"13360",2147,2129,2049,38,39,77
"13361",2232,2220,2049,83,90,173
"13362",43,31,2049,214,221,435
"13363",1256,1155,2053,187,175,362
"13364",1643,1526,2053,34,35,69
"13365",1423,1313,2054,68,68,136
"13366",1430,1229,2057,56,64,120
"13367",2037,1753,2060,125,128,253
"13368",41,2028,2060,113,88,201
"13369",1659,1615,2061,62,67,129
"13370",1922,1810,1102,52,40,92
"13371",2138,2121,1108,35,31,66
"13372",2251,2114,2023,134,119,253
"13373",2119,1751,2026,79,58,137
"13374",2101,1755,2026,61,62,123
"13375",1851,1831,2027,31,36,67
"13376",2120,1906,2028,63,56,119
"13377",2111,1852,2028,54,42,96
"13378",1913,1857,2031,66,82,148
"13379",1703,1541,2035,54,51,105
"13380",1651,1505,4497,31,45,76
"13381",1658,1508,4497,38,48,86
"13382",2106,1908,4497,121,123,244
"13383",1841,1649,4497,141,149,290
"13384",2018,1810,4497,238,230,468
"13385",1642,1410,4588,33,54,87
"13386",1744,1445,5806,59,69,128
"13387",1809,1417,5806,84,41,125
"13388",1823,1512,5806,104,102,206
"13389",1817,1507,5806,98,97,195
"13390",1721,1411,5806,36,35,71
"13391",1723,1609,5808,61,59,120
"13392",1723,1608,5808,61,58,119
"13393",1731,1622,5808,69,72,141
"13394",1752,1546,5808,90,36,126
"13395",1712,1551,5808,50,41,91
"13396",2135,2011,5810,48,46,94
"13397",2120,2009,5810,33,44,77
"13398",2139,2015,5810,52,50,102
"13399",1749,1429,5811,54,44,98
"13400",1301,1110,5811,38,40,78
"13401",1418,1223,5811,130,123,253
"13402",2337,2136,5817,60,66,126
"13403",2314,2102,5817,37,32,69
"13404",2358,2158,5817,81,88,169
"13405",27,2150,5817,110,80,190
"13406",2339,2110,5817,62,40,102
"13407",1952,1751,5818,144,141,285
"13408",1921,1731,5818,113,121,234
"13409",2115,1959,5819,143,139,282
"13410",1807,1645,5825,45,45,90
"13411",1817,1646,5825,55,46,101
"13412",1607,1513,5831,33,38,71
"13413",1905,1739,5832,60,56,116
"13414",1851,1728,5832,46,45,91
"13415",1908,1749,5832,63,66,129
"13416",931,826,5833,42,34,76
"13417",1816,1549,5834,87,69,156
"13418",2339,2217,5835,62,62,124
"13419",1328,1020,5841,67,65,132
"13420",236,2343,5845,165,168,333
"13421",23,2127,5845,32,32,64
"13422",12,2142,230,254,250,504
"13423",2044,1811,230,46,39,85
"13424",1839,1514,420,115,60,175
"13425",1510,1327,430,61,39,100
"13426",1507,1335,430,58,47,105
"13427",1206,1023,434,126,141,267
"13428",1122,905,434,72,52,124
"13429",2217,1942,439,137,132,269
"13430",1504,1355,441,55,65,120
"13431",1948,1730,515,106,120,226
"13432",1742,1517,535,380,387,767
"13433",1914,1508,552,69,64,133
"13434",1954,1534,552,109,90,199
"13435",2036,1628,552,166,153,319
"13436",1841,1614,588,39,44,83
"13437",1723,1448,624,38,33,71
"13438",1741,1501,624,56,46,102
"13439",1927,1657,670,87,87,174
"13440",1858,1605,776,56,35,91
"13441",1443,1319,801,34,31,65
"13442",1529,1350,801,80,60,140
"13443",1552,1423,841,103,95,198
"13444",1212,1018,855,69,73,142
"13445",1218,1014,855,75,69,144
"13446",1230,1019,855,87,74,161
"13447",1226,1039,855,83,94,177
"13448",1453,1310,855,230,247,477
"13449",1154,956,855,51,53,104
"13450",1247,1103,855,104,120,224
"13451",1223,1030,855,80,87,167
"13452",1142,955,855,39,52,91
"13453",1850,1456,993,43,50,93
"13454",915,551,996,34,40,74
"13455",1756,1424,1122,148,144,292
"13456",1246,1218,362,214,238,452
"13457",1945,1626,1978,47,61,108
"13458",2134,1810,1978,156,165,321
"13459",1945,1902,528,48,52,100
"13460",1936,1902,272,39,52,91
"13461",1928,1557,1978,35,37,72
"13462",1932,1909,272,35,59,94
"13463",1135,1101,362,143,161,304
"13464",1924,1554,1978,31,34,65
"13465",1806,1449,1170,264,277,541
"13466",734,710,270,48,60,108
"13467",132,2036,49,82,36,118
"13468",151,2044,677,221,169,390
"13469",1658,1612,31,43,47,90
"13470",2120,2038,2807,85,93,178
"13471",26,2310,267,71,85,156
"13472",102,2204,291,107,134,241
"13473",2127,2033,52,92,93,185
"13474",1941,1520,544,41,55,96
"13475",1646,1538,441,36,38,74
"13476",2354,2040,291,39,50,89
"13477",2057,2005,52,62,65,127
"13478",38,2126,291,83,96,179
"13479",1542,1243,1202,32,38,70
"13480",1245,1106,9,45,46,91
"13481",1357,1203,199,62,58,120
"13482",1848,1758,42,78,88,166
"13483",2030,1940,52,35,40,75
"13484",1819,1652,33,39,52,91
"13485",1940,1515,544,40,50,90
"13486",1611,1518,27,46,48,94
"13487",2327,2223,230,82,103,185
"13488",2039,1946,1559,34,46,80
"13489",10,2102,291,55,72,127
"13490",2011,1920,316,71,85,156
"13491",1334,1232,527,69,67,136
"13492",1742,1634,715,37,44,81
"13493",2103,2028,1493,33,43,76
"13494",14,2107,291,59,77,136
"13495",1902,1805,322,57,85,142
"13496",2331,2239,426,126,154,280
"13497",2156,2046,426,31,41,72
"13498",2128,2026,657,33,46,79
"13499",2217,1850,1294,32,45,77
"13500",2222,1859,1294,92,94,186
"13501",1631,1532,1632,51,67,118
"13502",1716,1340,1700,196,195,391
"13503",1540,1432,1848,160,167,327
"13504",2118,1646,622,78,91,169
"13505",2036,1611,622,36,56,92
"13506",2343,1847,622,223,212,435
"13507",2217,1737,622,137,142,279
"13508",1252,833,620,112,123,235
"13509",52,1958,622,292,283,575
"13510",2126,1646,622,86,91,177
"13511",2135,1626,622,95,71,166
"13512",3,1745,622,243,150,393
"13513",1518,1041,620,258,251,509
"13514",2012,1907,1250,62,92,154
"13515",12,2051,1268,86,86,172
"13516",1354,940,1429,95,110,205
"13517",1720,1619,1519,31,44,75
"13518",1852,1503,1551,40,33,73
"13519",1519,1428,1659,55,63,118
"13520",2033,1810,1718,147,160,307
"13521",1750,1622,1031,37,37,74
"13522",2116,1644,1274,40,64,104
"13523",1217,754,1440,47,39,86
"13524",1732,1405,1619,45,35,80
"13525",2351,1936,1658,32,31,63
"13526",2151,1930,1160,38,40,78
"13527",1830,1358,1431,49,48,97
"13528",1730,1551,1459,50,81,131
"13529",13,2159,1616,35,54,89
"13530",1520,1433,1646,87,98,185
"13531",1514,1116,1648,129,121,250
"13532",2102,1650,1676,61,70,131
"13533",1104,851,1024,56,66,122
"13534",1902,1511,1210,134,136,270
"13535",2305,1924,1263,31,34,65
"13536",1738,1630,1478,43,50,93
"13537",1459,1125,1650,60,70,130
"13538",1436,1104,1160,48,39,87
"13539",1723,1500,1177,38,35,73
"13540",1050,926,1400,35,35,70
"13541",1221,1046,1480,57,66,123
"13542",14,1944,1258,36,44,80
"13543",2042,2000,1297,123,135,258
"13544",1951,1622,1536,36,32,68
"13545",1459,1352,1608,45,47,92
"13546",1720,1630,6,50,60,110
"13547",2111,1952,47,34,42,76
"13548",2326,1948,1071,32,33,65
"13549",2307,2156,1112,53,46,99
"13550",2308,2012,1117,52,67,119
"13551",2018,1536,1122,148,146,294
"13552",1758,1515,1124,49,45,94
"13553",1645,1134,1128,100,69,169
"13554",1337,820,1143,78,40,118
"13555",2243,1841,1155,101,111,212
"13556",1911,1641,1166,58,71,129
"13557",1854,1448,1210,127,113,240
"13558",1204,1102,1211,103,112,215
"13559",1841,1356,1219,46,56,102
"13560",1929,1804,1227,69,64,133
"13561",1305,1221,1228,31,41,72
"13562",2021,1556,1243,57,41,98
"13563",44,2002,1258,66,62,128
"13564",1932,1519,1424,43,34,77
"13565",125,2100,1425,119,130,249
"13566",1916,1339,1433,186,129,315
"13567",1423,916,1437,62,31,93
"13568",1913,1808,1453,153,153,306
"13569",2236,2152,1479,39,52,91
"13570",1500,958,1483,61,43,104
"13571",2244,1927,1490,34,37,71
"13572",2252,2031,1512,72,91,163
"13573",34,2304,1526,107,129,236
"13574",1505,1059,1538,60,44,104
"13575",1417,1324,1555,52,64,116
"13576",1751,1422,1560,52,67,119
"13577",1619,1523,1589,46,58,104
"13578",2218,1744,1609,98,109,207
"13579",140,2110,1632,204,210,414
"13580",1113,806,1702,48,51,99
"13581",142,29,1203,183,194,377
"13582",1858,1818,1215,33,33,66
"13583",2354,2303,1479,117,123,240
"13584",2344,2241,1486,90,91,181
"13585",33,2216,1549,72,76,148
"13586",2341,2035,1562,40,55,95
"13587",2325,2212,1587,69,67,136
"13588",104,2145,1602,144,155,299
"13589",2301,2200,1672,35,45,80
"13590",1846,1409,1698,57,59,116
"13591",2155,2052,47,78,102,180
"13592",2051,1604,62,95,94,189
"13593",1231,947,1107,69,62,131
"13594",1756,1549,1148,50,59,109
"13595",1211,1056,1168,117,131,248
"13596",2121,2030,1441,80,80,160
"13597",7,2137,1512,147,157,304
"13598",1937,1540,1561,158,165,323
"13599",2352,2029,1562,51,49,100
"13600",1942,1851,1591,48,66,114
"13601",2044,1954,1624,100,124,224
"13602",1749,1323,60,66,83,149
"13603",1754,1632,1015,58,62,120
"13604",2036,1904,1108,63,89,152
"13605",1554,1138,1128,49,73,122
"13606",1055,1014,1136,45,59,104
"13607",1844,1521,1150,106,121,227
"13608",1943,1626,1188,45,41,86
"13609",1924,1829,1281,36,39,75
"13610",1643,1543,1296,95,83,178
"13611",2326,1941,1417,40,46,86
"13612",1706,1534,1446,127,154,281
"13613",1730,1413,1548,38,53,91
"13614",1359,1202,1669,35,37,72
"13615",2211,2031,1019,78,96,174
"13616",1226,1014,1061,86,74,160
"13617",2233,2114,1116,169,162,331
"13618",2344,2049,1117,88,104,192
"13619",1745,1412,1131,61,67,128
"13620",1702,1401,1135,54,61,115
"13621",2347,2206,1152,45,66,111
"13622",9,1945,1176,51,50,101
"13623",215,2213,1258,157,193,350
"13624",1948,1838,1281,60,48,108
"13625",1453,1249,1286,37,54,91
"13626",2208,2057,1420,149,152,301
"13627",110,2026,1425,104,96,200
"13628",1027,1006,1428,58,76,134
"13629",1221,1109,1476,32,39,71
"13630",120,2153,1501,157,178,335
"13631",1840,1738,1532,32,38,70
"13632",38,2348,1533,153,153,306
"13633",2036,1613,1561,217,198,415
"13634",2038,1609,1564,213,194,407
"13635",24,2040,1572,70,75,145
"13636",2258,1939,1586,38,41,79
"13637",2137,1625,1594,57,35,92
"13638",2252,2002,1599,37,37,74
"13639",1,1929,1609,201,214,415
"13640",2238,1841,1626,38,40,78
"13641",45,2030,1632,149,170,319
"13642",18,2334,1647,87,114,201
"13643",1354,1201,1669,35,36,71
"13644",2136,1721,1676,69,86,155
"13645",2100,1658,1688,60,63,123
"13646",2135,1707,1698,226,237,463
"13647",1926,1827,5,33,37,70
"13648",2238,1907,1124,191,202,393
"13649",1236,1008,1205,41,38,79
"13650",1626,1401,1212,64,59,123
"13651",2210,1816,1243,171,181,352
"13652",1922,1829,1281,39,39,78
"13653",1425,1332,1405,38,47,85
"13654",1622,1130,1433,37,35,72
"13655",46,2047,1441,38,46,84
"13656",2100,1737,1447,37,37,74
"13657",2023,1807,1468,34,37,71
"13658",1210,1041,1480,46,61,107
"13659",1625,1330,1547,130,105,235
"13660",1901,1621,1622,55,51,106
"13661",1925,1554,1645,155,169,324
"13662",1507,1146,1646,114,66,180
"13663",1355,1207,1669,36,42,78
"13664",1144,1054,1677,75,94,169
"13665",2002,1908,1689,83,93,176
"13666",2109,1709,1694,49,74,123
"13667",1242,944,1702,49,59,108
"13668",1352,1049,1,57,74,131
"13669",2307,2011,1117,51,66,117
"13670",1250,828,1143,31,48,79
"13671",1825,1614,1148,79,84,163
"13672",22,1958,1176,64,63,127
"13673",1554,1132,1209,256,237,493
"13674",2039,1935,1227,139,155,294
"13675",1312,1233,1228,38,53,91
"13676",113,2030,1258,95,90,185
"13677",2043,1940,1267,68,90,158
"13678",106,2357,1277,166,182,348
"13679",1943,1842,1281,55,52,107
"13680",1221,1036,1287,73,93,166
"13681",1931,1839,1297,52,54,106
"13682",206,55,1423,230,225,455
"13683",57,2006,1425,91,76,167
"13684",1952,1629,1536,37,39,76
"13685",40,2009,1540,130,137,267
"13686",2141,2017,1582,66,77,143
"13687",26,1959,1594,226,249,475
"13688",1638,1526,1605,204,216,420
"13689",39,2004,1609,239,249,488
"13690",126,2007,1632,190,147,337
"13691",1431,1236,1669,67,71,138
"13692",23,2321,1672,117,126,243
"13693",2038,1649,1688,38,54,92
"13694",1754,1650,1015,58,80,138
"13695",1836,1352,1122,46,42,88
"13696",1601,1120,1128,56,55,111
"13697",2030,1546,1243,66,31,97
"13698",33,1944,1258,55,44,99
"13699",2256,2206,1479,59,66,125
"13700",1616,1509,1485,36,54,90
"13701",2248,1931,1490,38,41,79
"13702",1603,1459,1557,54,44,98
"13703",1816,1447,1560,77,92,169
"13704",2126,1631,1594,46,41,87
"13705",1825,1440,1645,90,95,185
"13706",2258,1810,1676,151,135,286
"13707",2357,2025,1071,63,70,133
"13708",35,2127,1117,139,142,281
"13709",2333,2228,1203,54,73,127
"13710",2339,2220,1277,79,85,164
"13711",1329,937,1209,111,122,233
"13712",1739,1641,1478,44,61,105
"13713",1740,1345,1564,35,50,85
"13714",2123,1952,47,42,42,84
"13715",2158,1641,62,154,126,280
"13716",10,1923,857,200,208,408
"13717",1740,1309,883,42,39,81
"13718",1317,1129,1409,97,92,189
"13719",2352,2252,1423,96,102,198
"13720",2314,1719,1523,158,99,257
"13721",2347,2206,1538,61,76,137
"13722",2217,1742,1594,92,111,203
"13723",2233,2145,1602,133,145,278
"13724",3,2252,1622,99,117,216
"13725",1935,1411,1630,100,76,176
"13726",2342,1831,1632,82,51,133
"13727",2139,2038,1661,71,83,154
"13728",1442,1345,1717,51,60,111
"13729",2017,1952,1732,110,127,237
"13730",1102,837,1746,57,72,129
"13731",2308,1932,1748,46,42,88
"13732",1108,947,1791,71,77,148
"13733",2037,1850,1793,49,65,114
"13734",2357,2041,1830,83,101,184
"13735",7,2116,1846,63,71,134
"13736",2318,1932,1877,33,42,75
"13737",2100,1950,5,125,125,250
"13738",2143,2047,854,46,52,98
"13739",2316,1755,857,146,120,266
"13740",2048,1825,1015,41,41,82
"13741",2131,1727,1025,81,85,166
"13742",2250,2048,1033,114,113,227
"13743",16,2050,1042,59,70,129
"13744",49,2038,1410,69,83,152
"13745",2107,1741,1416,102,116,218
"13746",2347,1941,1417,56,51,107
"13747",2108,1744,1420,116,99,215
"13748",2317,2218,1423,59,68,127
"13749",2008,1524,1424,75,39,114
"13750",1821,1257,1433,132,87,219
"13751",2307,2036,1449,152,161,313
"13752",2259,1747,1458,148,112,260
"13753",2229,1656,1477,111,76,187
"13754",1454,928,1483,76,38,114
"13755",2350,2249,1486,79,94,173
"13756",145,56,1497,100,111,211
"13757",22,1935,1521,38,35,73
"13758",1613,1325,1547,112,100,212
"13759",1,2005,1595,49,60,109
"13760",2037,1923,1603,48,48,96
"13761",1934,1415,1624,104,65,169
"13762",1549,1318,1695,39,33,72
"13763",2115,1837,1705,309,307,616
"13764",2109,1911,1724,74,81,155
"13765",2350,2026,1748,88,96,184
"13766",1720,1501,1765,95,46,141
"13767",35,2320,1778,99,110,209
"13768",114,2227,1787,42,52,94
"13769",2053,1835,1789,56,65,121
"13770",1041,920,1791,49,50,99
"13771",2125,1927,1793,97,102,199
"13772",2010,1848,1795,34,37,71
"13773",1820,1625,1798,84,45,129
"13774",26,2324,1814,118,129,247
"13775",1658,1128,1819,93,48,141
"13776",1751,1327,1836,53,57,110
"13777",2115,2012,1841,58,67,125
"13778",2015,1922,1859,45,47,92
"13779",1842,1528,1874,86,58,144
"13780",2123,1948,47,49,38,87
"13781",1706,1555,137,76,85,161
"13782",1733,1423,146,87,53,140
"13783",2345,2048,1091,98,78,176
"13784",2145,1754,1416,147,129,276
"13785",2049,2007,1441,32,37,69
"13786",1432,953,1451,64,58,122
"13787",1059,838,1460,39,43,82
"13788",1954,1856,1521,72,81,153
"13789",1651,1555,1557,104,100,204
"13790",2239,2126,1597,31,31,62
"13791",2309,2000,1662,36,40,76
"13792",2100,1909,1724,72,79,151
"13793",2120,2026,1764,33,46,79
"13794",1925,1435,1811,100,85,185
"13795",7,2317,1814,104,122,226
"13796",1850,1521,1838,104,51,155
"13797",1451,1340,1899,40,35,75
"13798",1815,1655,1008,57,75,132
"13799",1842,1737,1046,59,62,121
"13800",1341,1246,1419,56,61,117
"13801",2034,1650,1424,101,125,226
"13802",1441,1127,1438,46,62,108
"13803",1732,1618,1798,31,33,64
"13804",1749,1703,35,86,95,181
"13805",2249,2021,1091,37,51,88
"13806",46,2052,1410,66,97,163
"13807",5,2257,1421,129,147,276
"13808",23,2222,1463,82,87,169
"13809",112,21,1479,180,191,371
"13810",1744,1332,1486,177,197,374
"13811",1638,1532,1575,46,57,103
"13812",926,830,1587,36,40,76
"13813",2051,2000,1602,31,40,71
"13814",1350,1117,1646,44,47,91
"13815",1623,1044,1712,44,34,78
"13816",2031,1840,1724,36,50,86
"13817",2059,2027,1732,152,162,314
"13818",2359,2007,1755,281,292,573
"13819",1350,902,1783,71,82,153
"13820",1847,1422,1811,54,72,126
"13821",18,2012,1839,49,82,131
"13822",1900,1534,1887,100,109,209
"13823",1802,1706,6,92,96,188
"13824",104,2127,1002,117,137,254
"13825",2036,1811,1015,43,41,84
"13826",1854,1609,1079,98,99,197
"13827",1139,1111,1411,124,141,265
"13828",2340,2204,1490,36,64,100
"13829",1432,1318,1605,74,88,162
"13830",1343,1126,1631,107,101,208
"13831",2108,1959,1661,40,44,84
"13832",13,2043,1678,70,93,163
"13833",1917,1812,1689,33,42,75
"13834",2038,1915,1795,62,64,126
"13835",2237,2108,1421,41,38,79
"13836",1933,1532,1424,40,47,87
"13837",103,2206,1427,56,56,112
"13838",2343,2240,1543,86,95,181
"13839",2131,1655,1594,46,64,110
"13840",2341,1911,1632,81,91,172
"13841",1345,1212,1673,37,32,69
"13842",2041,1627,1688,38,32,70
"13843",2004,1909,1779,71,79,150
"13844",9,2007,1839,40,77,117
"13845",2006,1704,1852,66,79,145
"13846",2213,1923,865,67,58,125
"13847",2342,1942,1002,37,32,69
"13848",2133,2023,1048,71,78,149
"13849",6,2048,1498,116,113,229
"13850",2220,1726,1523,104,106,210
"13851",1437,941,1529,56,56,112
"13852",2113,2022,1533,51,62,113
"13853",2012,1711,1546,62,41,103
"13854",2335,2205,1778,39,35,74
"13855",1325,831,1783,46,51,97
"13856",1737,1636,33,55,66,121
"13857",2134,2041,854,37,46,83
"13858",2008,1644,1416,43,59,102
"13859",131,2133,1417,160,163,323
"13860",2255,2142,1423,37,32,69
"13861",2351,2138,1465,48,48,96
"13862",2240,1738,1477,122,118,240
"13863",10,2107,1498,120,132,252
"13864",2343,2228,1525,77,93,170
"13865",2330,2221,1543,73,76,149
"13866",2045,1618,1606,93,33,126
"13867",1945,1437,1630,110,102,212
"13868",38,2023,1678,48,53,101
"13869",2049,1856,1724,54,66,120
"13870",307,2235,1751,186,215,401
"13871",1815,1404,1836,77,94,171
"13872",5,2302,1468,109,117,226
"13873",2045,1729,1524,47,34,81
"13874",2306,2147,1525,46,52,98
"13875",1444,1017,1549,142,147,289
"13876",1808,1456,1575,48,51,99
"13877",1833,1403,1606,163,188,351
"13878",1721,1510,1704,38,40,78
"13879",1635,1316,1752,75,76,151
"13880",2142,1727,1755,144,132,276
"13881",1717,1556,137,82,86,168
"13882",2135,1734,861,195,184,379
"13883",1910,1803,1046,87,88,175
"13884",12,2014,1410,32,59,91
"13885",1952,1603,1424,59,78,137
"13886",1545,1452,1557,32,37,69
"13887",1654,1553,1569,78,88,166
"13888",1136,1040,1583,87,90,177
"13889",1213,1104,1669,101,124,225
"13890",1841,1513,1692,51,58,109
"13891",1801,1638,1798,60,53,113
"13892",2352,2036,1830,78,96,174
"13893",2022,1723,1852,82,98,180
"13894",1540,1053,1877,54,39,93
"13895",1400,1124,1,65,109,174
"13896",1741,1635,33,59,65,124
"13897",1023,906,52,71,81,152
"13898",2017,1844,59,62,64,126
"13899",2120,1651,62,116,136,252
"13900",1121,707,89,61,67,128
"13901",2124,1644,857,34,49,83
"13902",2154,2027,1019,84,92,176
"13903",2221,2010,1033,85,75,160
"13904",2225,2118,1048,123,133,256
"13905",29,2231,1490,85,91,176
"13906",1625,1524,1541,63,54,117
"13907",2018,1749,1546,68,79,147
"13908",1751,1707,1557,163,177,340
"13909",1650,1534,1575,58,59,117
"13910",26,2101,1586,131,131,262
"13911",1506,1254,1669,100,89,189
"13912",1942,1623,1687,171,178,349
"13913",2143,1931,1724,108,101,209
"13914",1549,1344,1750,46,44,90
"13915",1824,1350,1811,31,40,71
"13916",1236,906,1849,99,101,200
"13917",2338,2109,1091,86,99,185
"13918",2112,1631,1523,36,51,87
"13919",2323,2240,1533,77,90,167
"13920",2335,2142,1724,220,232,452
"13921",2039,1817,1789,42,47,89
"13922",13,2330,1814,105,135,240
"13923",1938,1602,1850,154,167,321
"13924",1709,1548,137,74,78,152
"13925",1441,1045,1000,33,35,68
"13926",1652,1215,1099,83,96,179
"13927",1258,923,1487,128,118,246
"13928",1622,1530,1557,69,75,144
"13929",2317,1850,1632,57,70,127
"13930",1935,1859,1732,68,74,142
"13931",452,156,1,957,981,1938
"13932",1951,1838,59,36,58,94
"13933",2244,1815,857,114,140,254
"13934",2029,1703,1422,52,33,85
"13935",2324,2226,1423,68,76,144
"13936",2308,2217,1479,56,67,123
"13937",2325,2217,1543,68,72,140
"13938",11,2101,1556,36,51,87
"13939",1328,945,1590,150,150,300
"13940",2244,1715,1594,119,84,203
"13941",2359,2006,1595,48,61,109
"13942",119,2255,1616,90,110,200
"13943",2308,2200,1622,44,65,109
"13944",13,2004,1625,129,129,258
"13945",118,2040,1632,178,180,358
"13946",1452,1251,1669,87,86,173
"13947",2347,2015,1678,44,65,109
"13948",2317,2300,1692,89,115,204
"13949",1826,1720,1765,161,185,346
"13950",49,2337,1778,113,127,240
"13951",1806,1705,1798,65,80,145
"13952",2343,2258,1832,92,103,195
"13953",125,2000,1839,116,70,186
"13954",2137,1835,8,177,190,367
"13955",1736,1632,458,31,42,73
"13956",1751,1648,504,46,58,104
"13957",2230,2123,657,95,103,198
"13958",2330,2052,657,155,72,227
"13959",2320,2021,657,166,41,207
"13960",1730,1613,742,115,113,228
"13961",1613,1514,742,38,54,92
"13962",2153,1841,1294,63,76,139
"13963",2129,1812,1294,39,47,86
"13964",2242,1922,1294,112,117,229
"13965",2132,1806,1294,42,41,83
"13966",2148,1804,1294,58,39,97
"13967",1300,1206,1948,265,286,551
"13968",1052,942,1995,37,42,79
"13969",2108,1631,622,87,86,173
"13970",2013,1543,622,32,38,70
"13971",2114,1604,622,93,59,152
"13972",2053,1640,622,72,95,167
"13973",2051,1635,622,70,90,160
"13974",1724,1400,1,269,265,534
"13975",1719,1232,60,49,32,81
"13976",1555,1156,1010,84,81,165
"13977",1623,1510,1036,35,45,80
"13978",1941,1633,1089,39,48,87
"13979",945,820,1155,62,40,102
"13980",2255,2151,1242,42,41,83
"13981",1333,1226,1514,57,61,118
"13982",957,836,1516,59,71,130
"13983",2121,1710,1546,56,80,136
"13984",1458,1105,1558,62,55,117
"13985",1502,1221,1638,47,36,83
"13986",1920,1843,1707,33,48,81
"13987",2031,1821,5,95,31,126
"13988",2101,1933,33,264,243,507
"13989",2355,2238,47,189,208,397
"13990",2310,2144,59,227,229,456
"13991",2354,2200,1033,174,185,359
"13992",112,2242,1160,239,232,471
"13993",235,2208,1183,169,183,352
"13994",26,2106,1190,114,116,230
"13995",117,2147,1195,171,157,328
"13996",2236,2127,1204,228,217,445
"13997",2034,1936,1233,37,31,68
"13998",252,2306,1235,239,236,475
"13999",244,2228,1236,261,273,534
"14000",58,2157,1246,148,158,306
"14001",2028,1853,1250,78,78,156
"14002",18,2229,1258,227,244,471
"14003",2,2254,1259,94,103,197
"14004",200,2243,1268,194,198,392
"14005",2210,1754,1277,73,54,127
"14006",40,2222,1294,74,82,156
"14007",2350,2154,1299,225,244,469
"14008",55,2338,1406,151,168,319
"14009",133,2211,1417,186,196,382
"14010",39,2328,1442,149,153,302
"14011",8,2148,1468,153,168,321
"14012",103,2144,1477,145,149,294
"14013",2327,2215,1494,68,70,138
"14014",106,2232,1495,100,92,192
"14015",212,2157,1498,183,187,370
"14016",2105,1758,1503,126,88,214
"14017",2325,2236,1529,179,186,365
"14018",2358,1941,1533,32,41,73
"14019",2056,1947,1566,106,122,228
"14020",128,2216,1586,207,206,413
"14021",2229,2146,1591,52,56,108
"14022",2225,2131,1603,202,201,403
"14023",2236,1804,1615,90,69,159
"14024",24,2157,1616,46,52,98
"14025",216,2241,1654,224,226,450
"14026",2332,1944,1661,32,44,76
"14027",2305,1816,1680,155,139,294
"14028",2015,1853,1689,83,78,161
"14029",2303,2142,1705,208,202,410
"14030",2221,2148,1707,214,233,447
"14031",51,2349,1717,136,159,295
"14032",215,22,1721,195,207,402
"14033",2327,2031,1738,69,76,145
"14034",2021,1841,1741,78,51,129
"14035",2338,1815,1744,96,39,135
"14036",1918,1423,1087,88,78,166
"14037",932,813,1516,34,48,82
"14038",2322,1938,1654,50,43,93
"14039",2237,1808,1744,35,32,67
"14040",1108,1000,52,104,130,234
"14041",2332,2021,1477,54,66,120
"14042",2143,1705,1680,73,68,141
"14043",2347,1853,1744,105,77,182
"14044",1314,1208,1029,34,38,72
"14045",2028,1948,1233,31,43,74
"14046",2252,2200,1247,45,50,95
"14047",2334,2021,1268,48,56,104
"14048",1025,916,1409,105,111,216
"14049",1950,1848,1603,47,38,85
"14050",2354,1949,1658,35,44,79
"14051",2123,1949,47,37,39,76
"14052",2243,2014,1018,90,84,174
"14053",1956,1854,1704,46,69,115
"14054",2124,1738,1277,32,38,70
"14055",1823,1604,1460,85,94,179
"14056",1934,1838,5,38,48,86
"14057",2143,2029,47,57,79,136
"14058",1347,1251,1029,67,81,148
"14059",1934,1509,1136,107,114,221
"14060",1559,1143,1185,52,63,115
"14061",2301,1953,1195,35,43,78
"14062",1630,1203,1243,119,108,227
"14063",2350,2035,1268,64,70,134
"14064",1705,1247,1400,60,67,127
"14065",48,2017,1498,99,87,186
"14066",140,2101,1533,134,121,255
"14067",1718,1628,1639,97,104,201
"14068",2040,1624,1676,39,44,83
"14069",2249,1813,1680,139,136,275
"14070",1311,1206,1700,81,101,182
"14071",5,1952,1744,123,136,259
"14072",1924,1435,1087,94,90,184
"14073",1559,1432,1097,53,62,115
"14074",2304,1943,1134,63,48,111
"14075",1210,805,1440,40,50,90
"14076",36,2021,1498,87,91,178
"14077",1538,1152,1558,102,102,204
"14078",1330,1247,1620,70,72,142
"14079",1303,1133,1245,96,108,204
"14080",1921,1431,1431,100,81,181
"14081",1306,1150,1649,136,155,291
"14082",2058,1953,1705,83,93,176
"14083",2137,1947,1033,37,52,89
"14084",1824,1341,1087,34,36,70
"14085",2334,1951,1235,41,41,82
"14086",2240,2150,1247,33,40,73
"14087",2035,1906,1250,85,91,176
"14088",2116,1634,1274,40,54,94
"14089",2101,1903,1299,56,73,129
"14090",1918,1446,1431,97,96,193
"14091",1847,1743,1519,118,128,246
"14092",1209,821,1674,39,46,85
"14093",1229,832,1701,39,42,81
"14094",2014,1852,1704,38,52,90
"14095",1736,1255,60,76,65,141
"14096",1129,1016,1201,40,56,96
"14097",1659,1549,1257,62,69,131
"14098",1415,1312,1273,75,87,162
"14099",1133,900,1568,68,75,143
"14100",1143,816,1590,44,46,90
"14101",2331,2054,1018,138,124,262
"14102",1935,1629,1089,33,44,77
"14103",1547,1449,1232,34,34,68
"14104",2259,2123,1406,35,33,68
"14105",2306,1936,1417,39,41,80
"14106",1850,1610,1423,178,175,353
"14107",1936,1637,1460,153,127,280
"14108",1418,1220,1472,64,70,134
"14109",2226,1910,1503,207,160,367
"14110",2103,1651,1546,38,61,99
"14111",1736,1343,1589,43,46,89
"14112",25,2205,1616,47,60,107
"14113",1815,1502,1619,88,92,180
"14114",1944,1702,1718,98,92,190
"14115",1736,1512,1104,48,37,85
"14116",2056,1849,1299,56,59,115
"14117",1042,928,1430,38,43,81
"14118",2050,1709,1439,80,84,164
"14119",2048,1632,1546,31,42,73
"14120",1644,1532,1257,47,52,99
"14121",2224,2122,1591,47,32,79
"14122",2307,2139,1597,40,39,79
"14123",2326,2001,1654,54,66,120
"14124",2135,1932,1033,35,37,72
"14125",1725,1556,1097,139,146,285
"14126",1705,1250,1185,118,130,248
"14127",2315,1843,1236,52,48,100
"14128",1554,1242,1237,121,137,258
"14129",1923,1500,1431,102,110,212
"14130",1431,1219,1472,72,69,141
"14131",1939,1852,1603,36,42,78
"14132",1258,1041,1621,51,71,122
"14133",2029,1654,1688,32,49,81
"14134",1842,1630,1718,36,60,96
"14135",1940,1532,1133,64,52,116
"14136",2036,1834,1299,31,44,75
"14137",1818,1652,1420,115,122,237
"14138",2042,1600,62,106,95,201
"14139",1750,1632,1519,61,57,118
"14140",1934,1633,1710,47,48,95
"14141",2009,1910,1603,66,60,126
"14142",2100,1648,62,124,143,267
"14143",1448,1111,1085,60,56,116
"14144",2325,2011,1195,59,61,120
"14145",2335,1954,1235,42,44,86
"14146",1502,1231,1403,125,121,246
"14147",1500,1136,1690,33,31,64
"14148",21,1858,1710,204,118,322
"14149",2011,1900,59,48,60,108
"14150",1933,1631,1089,36,46,82
"14151",1555,1116,1131,39,36,75
"14152",1110,943,1430,66,58,124
"14153",2211,2049,47,85,99,184
"14154",2217,2001,1160,64,71,135
"14155",1636,1329,1177,165,174,339
"14156",1057,826,1568,32,41,73
"14157",1044,910,1574,39,40,79
"14158",1909,1439,1136,82,84,166
"14159",1649,1220,1185,102,100,202
"14160",2341,2243,1242,88,93,181
"14161",1513,1100,1243,42,45,87
"14162",1339,1224,1273,39,39,78
"14163",2041,1843,1299,36,53,89
"14164",1659,1236,1400,54,56,110
"14165",1505,1026,1414,75,67,142
"14166",2302,1935,1417,35,40,75
"14167",1123,1001,1430,74,76,150
"14168",2249,1752,1434,133,132,265
"14169",1213,803,1440,43,48,91
"14170",1735,1619,1519,46,44,90
"14171",2256,1852,1541,56,43,99
"14172",1856,1420,1562,121,103,224
"14173",1328,1248,1620,68,73,141
"14174",2114,1612,1676,73,32,105
"14175",2208,1732,1680,98,95,193
"14176",2319,1832,1744,77,56,133
"14177",1900,1347,1087,70,42,112
"14178",2015,1608,1133,99,88,187
"14179",2144,1702,1136,237,227,464
"14180",1624,1112,1185,77,32,109
"14181",2231,1715,1274,115,95,210
"14182",1730,1220,1400,85,40,125
"14183",1304,815,1440,94,60,154
"14184",2332,1932,1541,92,83,175
"14185",2204,1742,1549,121,97,218
"14186",1917,1545,1551,65,75,140
"14187",1911,1357,1562,143,87,230
"14188",2241,1928,1586,40,38,78
"14189",2209,1754,1615,63,59,122
"14190",2210,1733,1676,129,113,242
"14191",2119,1637,1680,49,40,89
"14192",2011,1936,1707,84,101,185
"14193",2003,1833,59,35,33,68
"14194",2034,1609,1071,78,54,132
"14195",2034,1439,1087,164,94,258
"14196",2006,1513,1136,139,118,257
"14197",1618,1152,1185,71,72,143
"14198",1833,1256,1400,148,76,224
"14199",2210,1716,1434,94,96,190
"14200",44,2000,1498,95,70,165
"14201",1242,1025,1539,43,50,93
"14202",2148,1641,1546,83,51,134
"14203",1957,1440,1562,189,130,319
"14204",27,1954,1632,145,138,283
"14205",17,2004,1658,58,59,117
"14206",2221,1733,1676,140,113,253
"14207",2314,1825,1680,164,148,312
"14208",2134,1733,1027,37,33,70
"14209",1447,1112,1237,54,47,101
"14210",4,1943,1533,38,43,81
"14211",1712,1605,1639,91,81,172
"14212",1032,813,1006,39,48,87
"14213",1346,918,1139,42,33,75
"14214",1131,952,1563,45,37,82
"14215",1721,1443,1638,191,178,369
"14216",1627,1528,1639,46,44,90
"14217",2303,2014,1738,45,59,104
"14218",1841,1345,1087,56,40,96
"14219",1707,1328,1128,75,38,113
"14220",1714,1055,1166,111,40,151
"14221",2243,2154,1234,45,42,87
"14222",2327,1846,1236,57,36,93
"14223",2347,2003,1688,55,53,108
"14224",2145,1926,1033,45,31,76
"14225",1745,1531,1036,117,66,183
"14226",1405,1317,1101,72,82,154
"14227",2053,1720,1552,76,90,166
"14228",2156,1840,54,51,45,96
"14229",2156,1843,54,51,48,99
"14230",2055,1755,8,143,150,293
"14231",2059,1745,8,147,140,287
"14232",2043,1747,8,131,142,273
"14233",1828,1749,1754,43,49,92
"14234",2020,1931,50,50,61,111
"14235",2248,2201,56,98,121,219
"14236",2035,1916,417,55,66,121
"14237",1828,1745,1300,38,45,83
"14238",1554,1039,2795,84,39,123
"14239",2324,2009,45,44,64,108
"14240",2134,2046,2076,44,66,110
"14241",2055,1936,1272,35,46,81
"14242",1911,1755,1926,51,55,106
"14243",1916,1648,2525,51,48,99
"14244",1945,1524,23,115,114,229
"14245",2156,2006,1390,31,56,87
"14246",1754,1705,243,39,45,84
"14247",1611,1504,32,76,64,140
"14248",1746,1652,40,46,52,98
"14249",1801,1711,42,31,41,72
"14250",2100,2005,50,90,95,185
"14251",2040,1946,52,40,46,86
"14252",12,2323,56,182,203,385
"14253",1439,1306,19,39,41,80
"14254",1525,1426,3059,40,31,71
"14255",1534,1117,2795,64,77,141
"14256",1551,1427,149,56,42,98
"14257",2025,1918,794,45,43,88
"14258",2124,1910,1186,69,80,149
"14259",2159,1955,801,64,60,124
"14260",1827,1415,23,37,45,82
"14261",2018,1942,1407,33,42,75
"14262",1757,1639,1665,32,39,71
"14263",2125,2045,1959,35,55,90
"14264",1803,1706,42,33,36,69
"14265",1436,1307,19,36,42,78
"14266",2029,1921,794,49,46,95
"14267",1709,1613,2210,44,48,92
"14268",2041,1937,1713,61,62,123
"14269",1343,943,1990,33,33,66
"14270",2059,2014,1980,114,134,248
"14271",1823,1707,766,38,47,85
"14272",2056,2001,939,86,96,182
"14273",2032,1943,1120,62,78,140
"14274",1851,1759,3163,71,74,145
"14275",1528,1425,1369,38,50,88
"14276",2120,2027,1281,35,47,82
"14277",2003,1849,127,53,54,107
"14278",107,2052,47,77,77,154
"14279",2125,1740,1687,205,220,425
"14280",1937,1846,48,37,46,83
"14281",2213,2123,56,63,83,146
"14282",2255,2210,58,80,100,180
"14283",2330,2243,60,95,103,198
"14284",1846,1721,35,41,51,92
"14285",1937,1850,1300,107,110,217
"14286",32,2126,45,112,141,253
"14287",2247,2148,3309,47,68,115
"14288",2055,1926,2313,35,36,71
"14289",1745,1440,1741,80,95,175
"14290",1731,1513,2191,41,48,89
"14291",2026,1951,1407,41,51,92
"14292",27,2136,1771,42,56,98
"14293",1701,1618,2363,56,58,114
"14294",1604,1506,34,34,36,70
"14295",1522,1412,783,32,47,79
"14296",1407,1250,1270,67,70,137
"14297",1148,1055,16,53,55,108
"14298",2029,1911,417,49,61,110
"14299",1807,1647,950,72,62,134
"14300",1843,1651,355,48,56,104
"14301",2215,2135,1959,85,105,190
"14302",29,2029,47,39,54,93
"14303",1543,1458,3059,58,63,121
"14304",1851,1725,113,86,85,171
"14305",2150,1851,39,45,81,126
"14306",2110,2031,1407,85,91,176
"14307",1655,1605,1021,55,55,110
"14308",2147,2057,49,62,62,124
"14309",1531,1414,783,41,49,90
"14310",1925,1751,35,80,81,161
"14311",1924,1833,1300,94,93,187
"14312",1216,1124,9,56,59,115
"14313",2143,1840,39,38,70,108
"14314",1716,1410,1741,51,65,116
"14315",2242,2034,2170,47,74,121
"14316",2219,2118,837,34,38,72
"14317",1322,1216,1334,47,41,88
"14318",1236,1140,1707,56,65,121
"14319",1641,1528,1759,221,223,444
"14320",2208,2116,263,48,51,99
"14321",1822,1735,1080,32,35,67
"14322",1733,1436,214,113,121,234
"14323",1910,1816,46,40,46,86
"14324",2020,1903,417,40,53,93
"14325",1947,1852,37,112,117,229
"14326",2221,2124,837,36,44,80
"14327",21,2127,1771,36,47,83
"14328",1435,1336,177,40,36,76
"14329",1828,1654,766,43,34,77
"14330",2325,2028,3034,35,48,83
"14331",2150,2051,2192,205,211,416
"14332",2129,2050,1754,224,230,454
"14333",2350,2222,879,75,102,177
"14334",1913,1821,243,118,121,239
"14335",1759,1659,40,59,59,118
"14336",1812,1708,42,42,38,80
"14337",1929,1817,44,89,77,166
"14338",1938,1836,46,68,66,134
"14339",1937,1841,48,37,41,78
"14340",2356,2246,52,236,226,462
"14341",2320,2212,56,130,132,262
"14342",2326,2216,58,111,106,217
"14343",2330,2220,60,95,80,175
"14344",2019,1854,35,134,144,278
"14345",2017,1920,1300,147,140,287
"14346",1530,1432,3059,45,37,82
"14347",2103,2006,1599,188,186,374
"14348",2340,2245,2076,170,185,355
"14349",1813,1707,3068,168,172,340
"14350",2246,2141,3309,46,61,107
"14351",1841,1700,113,76,60,136
"14352",2020,1902,1926,120,122,242
"14353",1911,1652,2525,46,52,98
"14354",1843,1744,37,48,49,97
"14355",2034,1920,2908,179,180,359
"14356",2005,1922,262,190,192,382
"14357",1810,1701,950,75,76,151
"14358",2155,2104,104,50,49,99
"14359",2018,1922,1080,148,142,290
"14360",1919,1729,2082,84,94,178
"14361",102,2211,1771,77,91,168
"14362",1805,1649,1665,40,49,89
"14363",755,701,1636,45,46,91
"14364",1552,1432,913,67,72,139
"14365",1718,1624,2210,53,59,112
"14366",1616,1508,1305,71,78,149
"14367",1829,1642,355,34,47,81
"14368",1905,1804,492,40,44,84
"14369",1441,1400,1673,86,90,176
"14370",1824,1742,1754,39,42,81
"14371",2123,2035,49,38,40,78
"14372",1606,1512,34,36,42,78
"14373",2153,2059,56,43,59,102
"14374",2041,1924,417,61,74,135
"14375",1523,1413,783,33,48,81
"14376",2002,1533,2347,37,33,70
"14377",1540,1122,2795,70,82,152
"14378",21,2330,55,106,125,231
"14379",1901,1437,23,71,67,138
"14380",2123,2048,1407,98,108,206
"14381",1756,1715,243,41,55,96
"14382",2016,1847,417,36,37,73
"14383",2025,1919,794,45,44,89
"14384",1559,1455,1574,34,35,69
"14385",1825,1736,1754,40,36,76
"14386",2124,2045,1959,34,55,89
"14387",1848,1647,31,83,77,160
"14388",1616,1525,34,46,55,101
"14389",1754,1653,38,84,83,167
"14390",2220,2132,58,45,62,107
"14391",1837,1714,35,32,44,76
"14392",1838,1749,1300,48,49,97
"14393",1845,1724,113,80,84,164
"14394",2225,1921,39,80,111,191
"14395",1852,1755,37,57,60,117
"14396",2153,2111,263,33,46,79
"14397",1844,1750,1080,54,50,104
"14398",2015,1817,355,140,142,282
"14399",1403,1111,7,58,71,129
"14400",2326,2039,43,101,129,230
"14401",1556,1501,32,61,61,122
"14402",1907,1823,1300,77,83,160
"14403",2055,1647,2347,90,107,197
"14404",1222,915,1490,57,70,127
"14405",1725,1512,2191,35,47,82
"14406",1814,1701,2908,39,41,80
"14407",1321,1133,2023,51,58,109
"14408",1818,1731,42,48,61,109
"14409",2020,1927,50,50,57,107
"14410",2308,2214,55,33,49,82
"14411",1231,1119,105,41,44,85
"14412",1647,1449,2112,117,119,236
"14413",1828,1632,2082,33,37,70
"14414",1835,1748,1754,50,48,98
"14415",2123,2039,1959,33,49,82
"14416",1900,1508,1687,60,68,128
"14417",1544,1452,32,49,52,101
"14418",1957,1906,48,57,66,123
"14419",1828,1740,1300,38,40,78
"14420",2049,1624,2347,84,84,168
"14421",1034,943,3,39,43,82
"14422",1509,1424,611,79,84,163
"14423",1829,1742,1080,39,42,81
"14424",1824,1733,1754,39,33,72
"14425",1539,1445,32,44,45,89
"14426",1934,1842,48,34,42,76
"14427",2104,2005,52,64,65,129
"14428",2015,1539,2347,50,39,89
"14429",2232,1959,2170,37,39,76
"14430",1110,926,148,75,81,156
"14431",1300,1209,20,65,69,134
"14432",1813,1719,42,43,49,92
"14433",1610,1455,783,80,90,170
"14434",1439,1310,19,39,45,84
"14435",2026,1603,2347,61,63,124
"14436",1615,1510,3068,50,55,105
"14437",2113,1848,1186,58,58,116
"14438",1755,1528,2191,65,63,128
"14439",1827,1734,37,32,39,71
"14440",18,2127,1771,33,47,80
"14441",2251,2211,1959,121,141,262
"14442",2353,2229,879,78,109,187
"14443",58,2110,47,68,95,163
"14444",2224,2137,49,99,102,201
"14445",1804,1708,243,49,48,97
"14446",1843,1726,42,73,56,129
"14447",2311,2147,46,281,257,538
"14448",2057,2005,52,57,65,122
"14449",2323,2138,56,133,98,231
"14450",2315,2148,58,100,78,178
"14451",2328,2148,60,93,48,141
"14452",2154,2032,417,134,142,276
"14453",1851,1702,35,46,32,78
"14454",2322,2008,45,42,63,105
"14455",1617,1317,261,37,47,84
"14456",2307,2218,55,32,53,85
"14457",2216,2112,2076,86,92,178
"14458",1332,1233,2100,42,43,85
"14459",2301,2155,3309,61,75,136
"14460",2139,2038,794,119,123,242
"14461",2223,2102,1272,123,132,255
"14462",2010,1822,1926,110,82,192
"14463",443,153,39,458,503,961
"14464",352,47,51,227,247,474
"14465",2250,2025,1186,155,155,310
"14466",2347,2123,2170,112,123,235
"14467",1836,1735,37,41,40,81
"14468",2229,2134,837,44,54,98
"14469",2253,2109,801,118,134,252
"14470",1856,1651,2908,81,31,112
"14471",1919,1825,262,144,135,279
"14472",2123,2053,1407,98,113,211
"14473",2301,2211,263,101,106,207
"14474",2105,1753,355,190,118,308
"14475",2331,2146,1390,126,156,282
"14476",2320,2027,43,95,117,212
"14477",42,2149,1771,57,69,126
"14478",2019,1731,1665,174,91,265
"14479",1708,1618,1574,103,118,221
"14480",1905,1814,46,35,44,79
"14481",2153,1728,2347,148,148,296
"14482",1622,1526,3254,42,41,83
"14483",2122,2026,2353,62,66,128
"14484",2049,1850,2103,81,75,156
"14485",1758,1418,2105,91,83,174
"14486",1104,752,2107,46,37,83
"14487",1039,943,2117,49,58,107
"14488",2301,2106,2121,71,71,142
"14489",2014,1723,2122,110,108,218
"14490",1709,1328,2125,42,33,75
"14491",1521,1323,2128,54,44,98
"14492",1024,934,2130,34,39,73
"14493",1112,1026,2130,82,91,173
"14494",2332,2228,2131,77,68,145
"14495",2322,2233,2131,72,73,145
"14496",1958,1814,2133,40,44,84
"14497",2310,2129,2133,232,239,471
"14498",2219,2029,2133,181,179,360
"14499",119,2320,2146,119,125,244
"14500",14,2210,2146,54,55,109
"14501",140,2336,2146,140,141,281
"14502",1819,1551,2147,89,71,160
"14503",1122,1033,2149,35,38,73
"14504",1415,1227,2149,38,42,80
"14505",1619,1506,2151,67,78,145
"14506",1606,1444,2151,54,56,110
"14507",1554,1439,2151,42,51,93
"14508",1823,1701,2162,44,46,90
"14509",1828,1701,2162,59,51,110
"14510",2115,1957,2162,221,227,448
"14511",2113,1950,2162,219,220,439
"14512",1138,1014,2163,76,79,155
"14513",2049,1920,2165,67,65,132
"14514",5,2223,2165,258,248,506
"14515",1447,1347,2171,132,137,269
"14516",1317,1201,2171,42,31,73
"14517",1501,1402,2171,146,152,298
"14518",1224,919,2171,36,39,75
"14519",1313,1001,2171,85,81,166
"14520",1504,1338,2174,32,33,65
"14521",1511,1347,2174,39,42,81
"14522",1531,1407,2174,59,62,121
"14523",1539,1417,2174,67,72,139
"14524",1754,1407,2182,37,42,79
"14525",1327,1203,2195,122,118,240
"14526",1322,1205,2195,117,120,237
"14527",1253,1121,2195,93,76,169
"14528",1201,1040,2195,36,35,71
"14529",1812,1457,2198,37,42,79
"14530",1926,1830,2205,51,50,101
"14531",1109,941,2206,40,51,91
"14532",1127,1024,2207,54,54,108
"14533",1105,1009,2207,32,39,71
"14534",1116,1015,2208,41,40,81
"14535",1928,1831,2212,58,61,119
"14536",2317,2214,2212,287,284,571
"14537",2122,2025,2212,172,175,347
"14538",27,2313,2212,357,343,700
"14539",1753,1432,2214,35,32,67
"14540",1813,1456,2214,55,56,111
"14541",1800,1439,2214,42,39,81
"14542",1750,1439,2214,32,39,71
"14543",2338,2041,2215,78,81,159
"14544",2351,2004,2215,77,74,151
"14545",2023,1730,2216,60,65,125
"14546",1903,1554,2222,143,139,282
"14547",1749,1425,2222,69,50,119
"14548",1426,1331,2223,39,41,80
"14549",1656,1548,2229,103,93,196
"14550",1558,1447,2229,45,32,77
"14551",1537,1233,2230,99,108,207
"14552",2152,2119,2235,184,199,383
"14553",1949,1735,2236,195,125,320
"14554",1712,1604,2236,38,34,72
"14555",1721,1622,2236,47,52,99
"14556",1211,840,2240,37,40,77
"14557",926,806,2241,38,36,74
"14558",1233,1110,2249,61,65,126
"14559",1356,1232,2249,144,147,291
"14560",1224,1100,2249,52,55,107
"14561",1205,1027,2252,46,47,93
"14562",1449,1137,2258,69,57,126
"14563",2219,2057,2258,52,57,109
"14564",49,2319,2258,192,199,391
"14565",2227,2057,2258,50,57,107
"14566",2300,2125,2258,83,85,168
"14567",58,7,2261,171,167,338
"14568",1511,1147,2268,219,227,446
"14569",1229,904,2268,57,64,121
"14570",1316,948,2268,104,108,212
"14571",1231,900,2268,59,60,119
"14572",1826,1634,2274,96,101,197
"14573",1822,1623,2274,92,90,182
"14574",2144,1759,2276,69,44,113
"14575",1426,1320,2277,99,100,199
"14576",1330,1225,2277,43,45,88
"14577",1324,1227,2277,37,47,84
"14578",1846,1639,2278,73,74,147
"14579",2254,2040,2280,87,40,127
"14580",2207,2041,2280,40,41,81
"14581",2226,2107,2280,60,64,124
"14582",14,2241,2283,186,191,377
"14583",2234,2055,2283,86,85,171
"14584",1312,1004,2283,84,84,168
"14585",2259,2045,2288,54,50,104
"14586",1602,1507,2290,40,42,82
"14587",1602,1510,2290,40,45,85
"14588",1819,1641,2292,39,36,75
"14589",1921,1603,2298,42,38,80
"14590",1634,1344,2299,55,39,94
"14591",1740,1503,2299,121,118,239
"14592",1157,1007,2302,50,52,102
"14593",1502,1338,2304,47,38,85
"14594",1250,1056,2306,45,41,86
"14595",1845,1738,2308,133,133,266
"14596",1718,1556,2308,46,31,77
"14597",1730,1624,2308,58,59,117
"14598",1454,1327,2316,44,32,76
"14599",2322,1924,2316,48,34,82
"14600",145,2202,2316,191,192,383
"14601",2309,1935,2316,40,45,85
"14602",2355,2002,2316,81,72,153
"14603",2337,1936,2316,63,46,109
"14604",2253,1952,2320,33,32,65
"14605",1232,910,2321,69,65,134
"14606",1951,1845,2326,36,40,76
"14607",1147,941,2328,40,41,81
"14608",2301,2001,2331,41,41,82
"14609",2314,2019,2331,54,59,113
"14610",1147,832,2332,39,47,86
"14611",1813,1502,2334,50,42,92
"14612",1823,1515,2334,60,55,115
"14613",1206,1013,2335,57,58,115
"14614",1630,1454,2336,40,41,81
"14615",1626,1452,2336,41,39,80
"14616",1711,1537,2336,81,84,165
"14617",2330,1947,2339,48,42,90
"14618",1109,1009,2342,41,49,90
"14619",1106,1002,2342,38,42,80
"14620",33,2102,2344,81,87,168
"14621",1,2037,2344,49,62,111
"14622",2343,2206,2345,155,156,311
"14623",55,8,2349,161,168,329
"14624",2333,2233,2349,79,73,152
"14625",15,2330,2350,128,130,258
"14626",2019,1923,2354,42,33,75
"14627",1624,1448,2356,115,113,228
"14628",2321,2223,2357,58,68,126
"14629",2311,2205,2357,48,50,98
"14630",1227,1056,2358,165,169,334
"14631",1718,1344,2360,46,44,90
"14632",149,2240,2364,202,220,422
"14633",2254,1943,2364,32,43,75
"14634",2056,1928,2369,33,33,66
"14635",2254,2128,2369,151,153,304
"14636",1219,913,2371,77,58,135
"14637",2334,2035,2375,42,60,102
"14638",159,2243,2375,187,188,375
"14639",2327,2013,2375,35,38,73
"14640",2345,2028,2375,53,53,106
"14641",7,2050,2375,75,75,150
"14642",2132,2000,2376,107,115,222
"14643",2026,1846,2376,41,41,82
"14644",7,2228,2379,69,68,137
"14645",1937,1834,2381,54,54,108
"14646",2302,2059,2385,72,64,136
"14647",2352,2212,2385,122,137,259
"14648",2357,2205,2385,127,130,257
"14649",2359,2140,2388,174,165,339
"14650",2149,1935,2388,44,40,84
"14651",2254,2051,2394,37,41,78
"14652",100,2309,2394,168,184,352
"14653",917,808,2395,40,48,88
"14654",2037,1857,2400,47,47,94
"14655",2112,1913,2400,82,63,145
"14656",2339,2208,2400,229,238,467
"14657",1905,1706,2404,70,39,109
"14658",1611,1511,2406,51,51,102
"14659",1543,1308,2406,116,108,224
"14660",1339,1253,2407,37,38,75
"14661",1339,1249,2407,32,34,66
"14662",1359,1258,2407,52,43,95
"14663",1402,1316,2407,55,61,116
"14664",2156,2113,2418,106,113,219
"14665",2050,2004,2418,40,44,84
"14666",1446,1333,2422,38,43,81
"14667",1505,1345,2422,57,55,112
"14668",1020,828,2426,43,53,96
"14669",1630,1504,2427,46,49,95
"14670",1759,1433,2428,64,58,122
"14671",1954,1627,2428,179,172,351
"14672",1845,1525,2428,110,110,220
"14673",1341,1221,2433,48,56,104
"14674",1227,1059,2434,55,54,109
"14675",1222,922,2435,52,57,109
"14676",1216,914,2435,48,51,99
"14677",1559,1505,2436,112,115,227
"14678",1042,918,2441,90,95,185
"14679",1815,1728,2442,97,103,200
"14680",1726,1635,2442,48,50,98
"14681",1730,1640,2442,52,55,107
"14682",1214,1054,2445,59,49,108
"14683",1937,1844,2446,42,44,86
"14684",2015,1907,2446,80,67,147
"14685",1948,1851,2446,53,51,104
"14686",2001,1909,2446,66,69,135
"14687",1059,957,2453,51,52,103
"14688",1557,1428,2456,83,88,171
"14689",1616,1442,2456,102,102,204
"14690",1610,1421,2456,96,81,177
"14691",1540,1408,2456,66,68,134
"14692",1559,1425,2456,85,85,170
"14693",1000,805,2458,43,40,83
"14694",1233,1125,2461,31,35,66
"14695",953,839,2461,31,34,65
"14696",2110,1928,2462,88,38,126
"14697",2047,1958,2462,65,68,133
"14698",2058,2009,2462,76,79,155
"14699",2239,2144,2462,177,174,351
"14700",2015,1927,2462,33,37,70
"14701",1744,1627,2465,39,47,86
"14702",1742,1630,2465,37,50,87
"14703",1755,1619,2465,50,39,89
"14704",1801,1643,2465,56,63,119
"14705",1820,1711,2467,31,36,67
"14706",2133,2017,2467,224,222,446
"14707",1345,1133,2470,158,153,311
"14708",1833,1518,2472,73,58,131
"14709",1848,1655,2474,84,85,169
"14710",1725,1418,2475,48,53,101
"14711",1109,915,2478,112,110,222
"14712",1121,935,2478,124,130,254
"14713",1825,1615,2479,125,125,250
"14714",1708,1452,2479,48,42,90
"14715",1757,1550,2479,97,100,197
"14716",2157,2103,2481,84,88,172
"14717",2318,2220,2481,165,165,330
"14718",2206,2106,2481,108,106,214
"14719",1225,1119,2482,32,34,66
"14720",1327,1208,2482,89,83,172
"14721",1838,1716,2485,59,71,130
"14722",2155,1806,2488,116,91,207
"14723",2051,1724,2488,52,49,101
"14724",2157,1836,2488,118,121,239
"14725",2013,1625,2492,51,40,91
"14726",2032,1708,2492,70,83,153
"14727",2347,2221,2493,52,61,113
"14728",109,2324,2493,134,124,258
"14729",2326,2200,2493,31,40,71
"14730",1257,1108,2495,72,63,135
"14731",2016,1718,2496,31,43,74
"14732",2042,1737,2496,57,62,119
"14733",2119,1819,2496,94,104,198
"14734",2113,1758,2496,88,83,171
"14735",1806,1634,2497,54,65,119
"14736",106,2200,2500,128,130,258
"14737",2400,2058,2500,62,68,130
"14738",111,2202,2500,133,132,265
"14739",143,2237,2500,165,167,332
"14740",2222,2051,2503,74,81,155
"14741",1742,1648,2509,67,63,130
"14742",1211,1106,2559,109,91,200
"14743",1303,1155,2559,161,140,301
"14744",1554,1457,2581,32,32,64
"14745",2015,1825,2598,47,50,97
"14746",1731,1622,2631,123,107,230
"14747",2233,2033,2651,38,33,71
"14748",1517,1145,2652,60,50,110
"14749",2139,2040,2683,64,80,144
"14750",1734,1417,2687,37,32,69
"14751",2023,1834,2759,46,34,80
"14752",2107,2007,2763,50,77,127
"14753",2328,2030,2782,56,55,111
"14754",2320,2017,2782,53,42,95
"14755",1806,1442,2791,71,67,138
"14756",1752,1406,2794,35,41,76
"14757",2146,2024,2804,83,89,172
"14758",31,2115,2822,74,65,139
"14759",1958,1828,2873,36,43,79
"14760",1839,1736,2936,124,111,235
"14761",2308,2129,2938,70,74,144
"14762",1826,1642,2944,52,37,89
"14763",2130,2005,2954,56,50,106
"14764",2136,2018,2954,62,63,125
"14765",1117,938,2967,60,43,103
"14766",2203,2051,3022,51,51,102
"14767",2005,1908,3027,38,48,86
"14768",1648,1503,3033,51,43,94
"14769",2232,2036,3038,42,41,83
"14770",1115,1014,3041,47,44,91
"14771",2015,1710,3042,48,45,93
"14772",2017,1659,3042,50,34,84
"14773",1415,1057,3043,55,42,97
"14774",1514,1146,3043,119,91,210
"14775",2302,2001,3050,42,41,83
"14776",2006,1901,3052,49,56,105
"14777",1752,1406,3078,35,36,71
"14778",1550,1342,3092,138,117,255
"14779",2250,2155,3103,33,35,68
"14780",2330,2142,3112,142,132,274
"14781",1618,1506,3120,128,131,259
"14782",1039,953,3148,41,48,89
"14783",2247,2051,3154,35,46,81
"14784",2031,1851,4560,54,51,105
"14785",1344,1158,4565,44,33,77
"14786",1232,1036,4567,73,56,129
"14787",1232,1102,4567,73,82,155
"14788",1637,1538,4570,39,48,87
"14789",1205,835,4575,52,50,102
"14790",1254,930,4575,101,105,206
"14791",2340,2034,4576,73,79,152
"14792",2117,2019,4578,42,59,101
"14793",1349,1255,4579,87,93,180
"14794",1445,1348,4579,143,146,289
"14795",1559,1259,4582,129,129,258
"14796",29,2330,4584,34,35,69
"14797",106,2359,4584,71,64,135
"14798",2225,2031,4585,35,36,71
"14799",2329,2119,4585,99,84,183
"14800",2309,2123,4585,79,88,167
"14801",56,2309,4585,186,194,380
"14802",1934,1653,4586,71,63,134
"14803",1258,1238,4589,78,98,176
"14804",1722,1600,4594,194,190,384
"14805",1319,1208,4596,47,43,90
"14806",2,2056,4596,55,61,116
"14807",1230,1129,4599,35,34,69
"14808",1235,1136,4599,40,41,81
"14809",1342,1205,4605,128,115,243
"14810",12,2110,4608,85,80,165
"14811",135,2235,4610,183,180,363
"14812",2149,2030,4611,49,60,109
"14813",2002,1700,4612,35,35,70
"14814",2028,1723,4612,63,58,121
"14815",2038,1741,4612,71,76,147
"14816",2143,2008,4616,125,118,243
"14817",1450,1225,4619,58,65,123
"14818",1542,1255,4619,110,95,205
"14819",1226,1116,4621,58,66,124
"14820",2141,2025,4622,67,70,137
"14821",2115,2005,4622,41,50,91
"14822",2111,2007,4623,36,47,83
"14823",2238,2123,4623,123,123,246
"14824",2204,2058,4623,89,98,187
"14825",2112,2009,4623,37,49,86
"14826",2335,2223,4623,180,183,363
"14827",1217,1119,4631,37,34,71
"14828",2004,1857,4635,47,52,99
"14829",2036,1912,4635,79,67,146
"14830",2147,1824,4637,32,34,66
"14831",2235,1825,4637,80,35,115
"14832",1437,1134,4639,77,79,156
"14833",1643,1512,4642,46,52,98
"14834",1646,1512,4642,49,52,101
"14835",1809,1634,4642,132,134,266
"14836",1631,1456,4642,34,36,70
"14837",1646,1515,4642,49,55,104
"14838",1754,1659,4643,82,84,166
"14839",1552,1238,4644,95,103,198
"14840",1457,1131,4644,45,36,81
"14841",1532,1211,4644,75,76,151
"14842",2059,1957,4645,42,67,109
"14843",2252,2202,4658,47,47,94
"14844",2337,2246,4658,92,91,183
"14845",1842,1730,4659,47,55,102
"14846",1914,1755,4659,79,80,159
"14847",1829,1720,4659,34,45,79
"14848",1524,1418,4662,79,83,162
"14849",1807,1450,4663,49,50,99
"14850",1824,1504,4663,66,64,130
"14851",1809,1455,4663,51,55,106
"14852",2142,2005,4665,140,140,280
"14853",2121,1939,4665,119,114,233
"14854",1529,1410,4666,51,60,111
"14855",1804,1633,4669,37,33,70
"14856",1804,1406,4671,47,36,83
"14857",1821,1404,4671,64,34,98
"14858",1121,1019,4674,46,44,90
"14859",1203,1113,4674,88,98,186
"14860",2100,2000,4684,43,40,83
"14861",2133,2044,4684,76,84,160
"14862",2306,2218,4684,169,178,347
"14863",1545,1425,4685,58,65,123
"14864",1825,1517,4687,66,67,133
"14865",1651,1543,4693,39,38,77
"14866",1811,1707,4693,119,122,241
"14867",1635,1329,4701,43,39,82
"14868",1625,1321,4701,33,31,64
"14869",1932,1617,4701,220,207,427
"14870",1123,1033,4703,55,63,118
"14871",2244,2106,4704,51,56,107
"14872",1926,1550,4705,214,85,299
"14873",2029,1942,4706,115,122,237
"14874",2058,2007,4706,144,147,291
"14875",1921,1831,4706,47,51,98
"14876",2345,2233,4710,153,153,306
"14877",2144,2037,4710,32,37,69
"14878",2207,2057,4710,55,57,112
"14879",2206,2051,4710,54,51,105
"14880",1405,1247,6097,141,154,295
"14881",1249,1115,6097,65,62,127
"14882",1249,1115,6101,63,60,123
"14883",1231,1120,6101,53,80,133
"14884",2136,1838,1958,140,148,288
"14885",1336,1043,1590,71,79,150
"14886",1938,1612,8,66,47,113
"14887",2223,1836,54,103,63,166
"14888",2154,1821,1958,158,131,289
"14889",1647,1353,1675,45,53,98
"14890",2219,1918,1958,183,188,371
"14891",1518,1156,810,303,292,595
"14892",1908,1559,8,36,34,70
"14893",2316,2022,54,156,169,325
"14894",1147,824,4882,35,59,94
"14895",1243,908,5135,100,118,218
"14896",2119,1748,5152,41,58,99
"14897",2154,1733,5152,76,43,119
"14898",1046,925,5234,189,200,389
"14899",2024,1836,5245,140,121,261
"14900",1731,1403,5478,62,83,145
"14901",1703,1344,5478,34,64,98
"14902",1706,1316,5478,37,36,73
"14903",2211,2048,147,86,88,174
"14904",2121,2003,147,57,64,121
"14905",2244,2124,147,140,145,285
"14906",2134,1832,292,56,57,113
"14907",1753,1454,288,34,34,68
"14908",2235,1953,296,61,72,133
"14909",2049,1747,288,115,108,223
"14910",1652,1342,286,54,39,93
"14911",2339,2206,2870,239,216,455
"14912",2310,2035,2870,210,125,335
"14913",1221,1116,2958,41,46,87
"14914",1102,953,3210,37,38,75
"14915",2330,2144,3328,170,129,299
"14916",2255,2015,3717,115,110,225
"14917",2156,1933,3717,56,68,124
"14918",2143,1904,3717,43,39,82
"14919",1608,1449,3719,128,144,272
"14920",1445,1329,3719,45,64,109
"14921",1701,1550,3719,181,205,386
"14922",2257,2117,3724,57,47,104
"14923",2044,1811,3786,134,141,275
"14924",1919,1705,3786,49,75,124
"14925",1433,1206,3796,48,51,99
"14926",1431,1223,3796,46,68,114
"14927",1806,1609,2026,32,39,71
"14928",1936,1811,2031,89,36,125
"14929",1958,1925,2031,111,110,221
"14930",2,2129,2038,152,154,306
"14931",2209,1951,2038,39,56,95
"14932",1,2007,2042,61,67,128
"14933",1657,1525,2045,64,35,99
"14934",1654,1553,2045,56,63,119
"14935",1648,1546,2045,50,56,106
"14936",1710,1553,2045,77,63,140
"14937",1658,1453,2016,74,63,137
"14938",2158,2037,2022,54,57,111
"14939",2342,2220,2022,158,160,318
"14940",1623,1339,2019,44,44,88
"14941",1610,1329,2019,31,34,65
"14942",2150,2028,2022,46,48,94
"14943",1941,1840,2029,62,70,132
"14944",2212,1953,2030,105,98,203
"14945",1918,1806,2029,39,36,75
"14946",2045,1942,2029,126,132,258
"14947",1009,940,2028,45,45,90
"14948",101,2356,2008,167,181,348
"14949",2303,2156,2008,49,61,110
"14950",2249,2144,2008,35,49,84
"14951",1126,1101,2028,72,81,153
"14952",1704,1541,2053,55,50,105
"14953",22,2249,2055,75,94,169
"14954",2143,2020,2022,39,40,79
"14955",1459,1254,2066,77,74,151
"14956",6,2243,2020,86,113,199
"14957",44,2106,2060,116,126,242
"14958",1203,827,2061,39,37,76
"14959",1255,911,2061,91,81,172
"14960",2128,1814,2062,103,89,192
"14961",2112,1748,2062,87,63,150
"14962",2044,1741,2062,59,56,115
"14963",1105,958,2047,60,58,118
"14964",1049,937,2047,44,37,81
"14965",18,2046,2049,91,101,192
"14966",15,2045,2049,88,100,188
"14967",1824,1629,2051,42,44,86
"14968",1713,1533,2053,64,42,106
"14969",2234,2044,4455,94,119,213
"14970",2225,2018,4455,85,93,178
"14971",1417,1056,2013,35,36,71
"14972",1442,1127,2013,60,67,127
"14973",1426,1211,2007,86,101,187
"14974",921,655,5349,50,55,105
"14975",909,643,5349,38,43,81
"14976",2222,1920,5802,97,95,192
"14977",38,2146,5802,233,241,474
"14978",2205,1846,5802,80,61,141
"14979",2252,2133,5807,34,43,77
"14980",1649,1347,5807,67,34,101
"14981",1305,1008,5808,46,53,99
"14982",1208,1125,5813,44,50,94
"14983",1241,1150,5813,82,75,157
"14984",121,39,5815,99,99,198
"14985",1950,1832,5824,53,52,105
"14986",1036,942,5833,107,110,217
"14987",934,827,5833,45,35,80
"14988",1910,1813,5834,35,38,73
"14989",1909,1806,5834,34,31,65
"14990",2123,2029,5837,31,44,75
"14991",2335,2244,5837,163,179,342
"14992",2159,2102,5837,67,77,144
"14993",2208,2056,5837,76,71,147
"14994",1555,1432,5841,68,57,125
"14995",1530,1427,5841,43,52,95
"14996",1520,1411,5841,33,36,69
"14997",1911,1809,5843,187,177,364
"14998",1735,1639,5843,91,87,178
"14999",1643,1545,5843,39,33,72
"15000",1023,727,6203,112,87,199
"15001",943,722,6203,72,82,154
"15002",951,710,6203,80,70,150
"15003",2050,1804,230,54,34,88
"15004",2045,1828,230,49,58,107
"15005",2038,1809,230,42,39,81
"15006",30,2157,230,274,267,541
"15007",1027,907,661,42,42,84
"15008",1258,1040,855,105,90,195
"15009",1153,956,855,47,56,103
"15010",1142,944,855,36,44,80
"15011",1205,944,855,59,44,103
"15012",1149,1009,855,43,69,112
"15013",2101,1900,855,586,588,1174
"15014",1556,1235,1170,134,143,277
"15015",1314,932,1220,53,40,93
"15016",1115,701,1776,44,46,90
"15017",1933,1518,1824,123,124,247
"15018",1557,1232,1170,136,137,273
"15019",29,2115,1679,202,215,417
"15020",1700,1347,1702,94,107,201
"15021",1430,1116,1220,130,146,276
"15022",1158,1116,362,165,181,346
"15023",2003,1642,1978,62,72,134
"15024",1037,721,996,116,126,242
"15025",2028,1655,1978,87,85,172
"15026",2057,2022,272,109,132,241
"15027",2305,1949,1679,118,129,247
"15028",9,1943,1828,129,118,247
"15029",1548,1234,1699,78,84,162
"15030",1757,1707,243,42,47,89
"15031",1906,1817,44,66,77,143
"15032",2027,1917,417,47,67,114
"15033",2128,1708,2347,123,128,251
"15034",1805,1647,1665,40,47,87
"15035",1634,1533,36,34,33,67
"15036",2107,1903,417,87,53,140
"15037",2051,1935,1272,31,45,76
"15038",2222,2128,310,87,88,175
"15039",1955,1914,628,35,49,84
"15040",2331,2241,2673,251,256,507
"15041",2323,2016,2317,33,36,69
"15042",2113,1900,1151,113,120,233
"15043",1949,1904,846,34,39,73
"15044",1701,1509,1019,36,39,75
"15045",1637,1305,954,62,35,97
"15046",30,2020,47,55,45,100
"15047",1622,1151,827,112,111,223
"15048",2103,2000,1808,43,40,83
"15049",1945,1850,46,75,80,155
"15050",2133,2032,56,38,32,70
"15051",28,2340,58,183,190,373
"15052",2258,1945,45,33,40,73
"15053",1711,1617,3254,91,92,183
"15054",2054,1949,2601,74,74,148
"15055",56,2338,1484,276,288,564
"15056",1711,1612,2428,46,47,93
"15057",2159,2007,2062,44,52,96
"15058",2028,1955,1407,43,55,98
"15059",105,14,56,235,254,489
"15060",2114,1610,2347,109,70,179
"15061",2127,1628,23,217,178,395
"15062",1620,1330,214,40,55,95
"15063",1758,1650,458,53,60,113
"15064",2139,2033,657,44,53,97
"15065",1930,1805,742,235,225,460
"15066",1616,1516,742,41,56,97
"15067",1607,1456,742,32,36,68
"15068",1610,1516,742,35,56,91
"15069",2,2305,742,507,525,1032
"15070",2136,1816,1294,46,51,97
"15071",2231,1909,1294,101,104,205
"15072",2242,1924,1294,112,119,231
"15073",1331,1218,1848,31,33,64
"15074",1356,1256,1848,56,71,127
"15075",1404,1255,1848,64,70,134
"15076",1455,1356,1848,115,131,246
"15077",1454,1138,1946,74,83,157
"15078",1622,1250,1946,162,155,317
"15079",1414,1101,1946,34,46,80
"15080",1425,1106,1946,45,51,96
"15081",1148,1011,1995,93,71,164
"15082",1048,938,1995,33,38,71
"15083",1114,957,1995,59,57,116
"15084",2206,1921,731,49,41,90
"15085",2041,1612,622,60,67,127
"15086",2104,1635,622,83,90,173
"15087",2013,1610,622,32,65,97
"15088",2103,1611,622,82,66,148
"15089",17,2015,622,276,310,586
"15090",1442,1128,1,92,113,205
"15091",1650,1501,1008,50,36,86
"15092",1454,1019,1104,84,83,167
"15093",2102,1837,1132,58,52,110
"15094",1735,1327,1472,45,57,102
"15095",1227,913,1590,85,108,193
"15096",2132,2011,47,46,61,107
"15097",1516,1432,1018,79,87,166
"15098",2319,2152,1093,56,52,108
"15099",2252,2149,1180,158,154,312
"15100",1424,1257,1240,142,147,289
"15101",1646,1415,1467,53,60,113
"15102",1459,1140,1564,56,75,131
"15103",2310,2155,1597,38,50,88
"15104",2200,1932,1623,103,86,189
"15105",1324,1148,1649,158,156,314
"15106",1855,1729,1015,93,89,182
"15107",2203,1823,1075,52,83,135
"15108",1909,1433,1241,79,73,152
"15109",1803,1335,1243,201,195,396
"15110",2354,2251,1259,88,96,184
"15111",1843,1435,1472,71,80,151
"15112",6,2007,1498,58,77,135
"15113",2355,1954,1578,205,238,443
"15114",2009,1626,1648,62,41,103
"15115",2308,2212,1687,61,62,123
"15116",2009,1904,5,66,69,135
"15117",1945,1536,62,45,71,116
"15118",2001,1840,1689,48,60,108
"15119",1255,1138,1696,68,68,136
"15120",1805,1636,1015,35,36,71
"15121",1416,940,1104,46,45,91
"15122",1300,855,1122,39,65,104
"15123",1608,1141,1179,57,61,118
"15124",1922,1441,1241,89,81,170
"15125",112,2247,1431,140,112,252
"15126",27,2013,1476,67,68,135
"15127",2152,1715,1494,69,90,159
"15128",113,2035,1498,122,105,227
"15129",2319,1918,1541,79,69,148
"15130",2255,1744,1578,142,108,250
"15131",1651,1242,1621,48,68,116
"15132",121,2029,1658,194,169,363
"15133",2253,1830,1676,155,150,305
"15134",916,813,128,41,50,91
"15135",1945,1816,1250,32,36,68
"15136",1609,1050,1573,31,31,62
"15137",1738,1301,60,68,61,129
"15138",2144,1928,1033,43,33,76
"15139",2022,1847,1430,46,47,93
"15140",2035,1710,1648,85,85,170
"15141",1414,940,1104,44,45,89
"15142",2247,2215,1123,73,85,158
"15143",2215,2154,1123,41,64,105
"15144",33,2208,1184,41,48,89
"15145",1502,1408,1186,32,43,75
"15146",1201,925,1585,39,35,74
"15147",1304,1031,1725,60,61,121
"15148",2042,1854,1132,41,69,110
"15149",1725,1300,1277,81,95,176
"15150",1111,958,1081,57,68,125
"15151",1230,1108,1201,92,98,190
"15152",2128,2032,1602,32,46,78
"15153",1137,719,89,77,79,156
"15154",2251,2003,1003,36,53,89
"15155",1122,732,1174,52,47,99
"15156",1213,1045,1201,75,75,150
"15157",1617,1216,1243,98,116,214
"15158",2350,2240,1259,81,85,166
"15159",1230,821,1279,57,66,123
"15160",243,2243,1463,93,108,201
"15161",1758,1347,1472,68,77,145
"15162",1827,1716,1488,41,41,82
"15163",2258,1901,1541,58,52,110
"15164",1656,1510,1008,56,45,101
"15165",2344,2212,1019,183,182,365
"15166",1422,1242,1023,77,60,137
"15167",1854,1337,1087,64,32,96
"15168",2247,2010,1091,84,80,164
"15169",1557,1115,1179,46,35,81
"15170",2024,1539,1241,151,139,290
"15171",1702,1410,1266,42,60,102
"15172",1928,1652,1278,79,82,161
"15173",1849,1420,1472,119,110,229
"15174",5,2014,1476,45,69,114
"15175",2119,1633,1494,36,48,84
"15176",33,2043,1498,82,113,195
"15177",2112,1807,1503,122,92,214
"15178",1756,1510,1505,50,40,90
"15179",2116,1622,1546,49,32,81
"15180",2149,1742,1578,76,106,182
"15181",1801,1332,1621,118,118,236
"15182",19,2029,1658,132,169,301
"15183",2132,1719,1676,74,79,153
"15184",2318,2237,1123,104,107,211
"15185",2119,1857,1132,75,72,147
"15186",1752,1555,1008,112,90,202
"15187",1421,1251,1011,50,61,111
"15188",1443,1056,1027,35,36,71
"15189",2013,1657,1089,65,67,132
"15190",1722,1331,1116,170,176,346
"15191",1549,1256,1151,227,201,428
"15192",1407,1143,1173,146,133,279
"15193",1638,1225,1179,87,105,192
"15194",2221,1955,1198,115,115,230
"15195",1314,1152,1201,136,142,278
"15196",1535,1235,1202,130,145,275
"15197",1922,1834,1204,52,54,106
"15198",1416,1320,1231,112,104,216
"15199",1609,1244,1237,131,134,265
"15200",1803,1325,1243,204,185,389
"15201",1525,1233,1275,85,68,153
"15202",1325,1231,1280,33,46,79
"15203",112,2259,1401,136,129,265
"15204",1429,1212,1403,85,102,187
"15205",1300,1159,1415,77,89,166
"15206",1619,1516,1425,34,41,75
"15207",1600,1209,1444,72,79,151
"15208",2340,2032,1543,76,92,168
"15209",1056,943,1545,34,38,72
"15210",1505,1248,1562,47,63,110
"15211",1750,1234,1573,132,135,267
"15212",2052,1851,1623,35,45,80
"15213",1438,1311,1629,80,91,171
"15214",1726,1622,1639,98,97,195
"15215",1901,1657,1652,131,137,268
"15216",1443,1145,1656,45,55,100
"15217",2054,1720,1688,57,85,142
"15218",1622,1304,1690,129,149,278
"15219",1443,1307,1696,176,157,333
"15220",2124,1958,47,38,48,86
"15221",2247,1949,1003,32,39,71
"15222",1825,1648,1015,55,48,103
"15223",2232,2014,1033,91,79,170
"15224",1150,1028,1239,47,58,105
"15225",1414,1238,1240,132,128,260
"15226",1847,1729,1257,87,94,181
"15227",48,2050,1476,52,69,121
"15228",2020,1744,1503,70,69,139
"15229",1729,1401,1640,33,31,64
"15230",1751,1637,1031,56,62,118
"15231",2223,1837,1075,72,97,169
"15232",1548,1118,1243,66,58,124
"15233",1818,1436,1598,86,96,182
"15234",12,2034,1730,62,71,133
"15235",1609,1131,1179,58,51,109
"15236",1856,1359,1241,63,39,102
"15237",9,2100,1256,79,95,174
"15238",1435,950,1414,43,35,78
"15239",16,2001,1498,65,71,136
"15240",1352,1249,1520,51,64,115
"15241",2305,1846,1524,40,51,91
"15242",1742,1403,1569,45,43,88
"15243",2123,1956,1577,42,46,88
"15244",2134,1703,1578,61,67,128
"15245",2312,2000,1588,31,40,71
"15246",2339,2222,1597,67,77,144
"15247",1700,1206,1621,57,32,89
"15248",1205,1053,1649,76,101,177
"15249",17,1940,1658,130,120,250
"15250",1943,1857,1709,51,67,118
"15251",1717,1550,1008,77,85,162
"15252",1244,822,1025,33,42,75
"15253",1953,1628,1089,45,38,83
"15254",1819,1347,1162,34,37,71
"15255",1631,1157,1179,80,77,157
"15256",1156,1039,1239,50,69,119
"15257",1858,1425,1241,65,65,130
"15258",1551,1145,1243,72,85,157
"15259",1248,826,1279,75,71,146
"15260",1425,1003,1414,33,48,81
"15261",1618,1515,1425,33,40,73
"15262",1743,1321,1472,53,51,104
"15263",1,2000,1476,41,55,96
"15264",2207,1653,1494,84,68,152
"15265",2107,1622,1546,40,32,72
"15266",2105,1651,1578,32,55,87
"15267",1748,1301,1621,105,87,192
"15268",1527,1237,1656,89,107,196
"15269",2306,1843,1658,59,63,122
"15270",2110,1655,1676,52,55,107
"15271",1829,1355,1087,39,50,89
"15272",1559,1408,1097,78,63,141
"15273",2228,2151,1123,54,61,115
"15274",1803,1430,1403,72,85,157
"15275",2035,1646,1439,61,61,122
"15276",1920,1528,1539,37,43,80
"15277",106,2317,1712,128,147,275
"15278",2142,1947,1033,41,52,93
"15279",2241,1944,1198,135,104,239
"15280",1036,955,1272,36,50,86
"15281",1657,1615,1459,98,110,208
"15282",2306,2023,1033,125,88,213
"15283",2058,1831,1132,54,46,100
"15284",32,2200,1184,40,40,80
"15285",1806,1651,1257,46,56,102
"15286",1458,1223,1275,58,58,116
"15287",1530,1135,1444,42,45,87
"15288",2047,1639,1539,124,114,238
"15289",2256,1933,1586,48,43,91
"15290",1903,1447,1640,127,77,204
"15291",2116,1749,1648,126,124,250
"15292",1926,1656,1652,156,136,292
"15293",1655,1410,1680,105,70,175
"15294",1506,1141,1690,50,66,116
"15295",1418,1203,1693,40,33,73
"15296",2005,1840,1705,46,40,86
"15297",113,2230,1712,135,100,235
"15298",2203,2049,5,180,174,354
"15299",1915,1802,6,141,127,268
"15300",1712,1617,35,47,47,94
"15301",2119,2000,47,33,50,83
"15302",110,2051,62,370,386,756
"15303",2307,1927,1000,207,222,429
"15304",2109,1923,1008,309,298,607
"15305",1616,1332,1011,168,102,270
"15306",2044,1914,1031,226,219,445
"15307",2143,1942,1033,42,47,89
"15308",2050,1929,1036,295,299,594
"15309",1707,1534,1045,65,49,114
"15310",2318,1916,1075,127,136,263
"15311",2015,1445,1087,151,115,266
"15312",2344,2026,1089,276,276,552
"15313",2155,1929,1091,32,39,71
"15314",2314,2205,1093,51,65,116
"15315",1524,1049,1104,114,109,223
"15316",2216,2140,1123,42,50,92
"15317",1731,1409,1148,41,39,80
"15318",2239,1921,1155,32,31,63
"15319",2103,2010,1180,49,55,104
"15320",213,2356,1184,141,156,297
"15321",1542,1402,1186,72,37,109
"15322",2210,1948,1198,87,91,178
"15323",2320,2230,1234,81,86,167
"15324",32,2054,1235,114,124,238
"15325",1426,1108,1237,31,38,69
"15326",2126,1653,1241,213,213,426
"15327",1651,1549,1244,244,239,483
"15328",2359,2035,1256,69,70,139
"15329",1902,1754,1257,102,119,221
"15330",309,2241,1268,202,216,418
"15331",2253,2027,1282,77,92,169
"15332",153,3,1401,177,193,370
"15333",2156,1719,1407,73,94,167
"15334",55,2355,1418,162,175,337
"15335",2122,1916,1420,39,41,80
"15336",1759,1651,1423,134,141,275
"15337",2015,1647,1439,41,62,103
"15338",5,2018,1453,65,71,136
"15339",1755,1713,1459,156,168,324
"15340",1802,1337,1472,72,67,139
"15341",54,2037,1476,58,56,114
"15342",2107,1807,1492,133,137,270
"15343",57,2243,1501,472,488,960
"15344",2046,1809,1511,220,219,439
"15345",16,2158,1514,47,63,110
"15346",1749,1328,1515,113,58,171
"15347",1500,1307,1520,122,82,204
"15348",2343,2234,1530,93,99,192
"15349",30,2052,1533,116,117,233
"15350",1943,1536,1539,60,51,111
"15351",2306,1913,1541,66,64,130
"15352",2303,1937,1543,39,37,76
"15353",2055,2008,1550,42,53,95
"15354",1622,1528,1551,75,75,150
"15355",1806,1417,1561,75,52,127
"15356",1736,1405,1562,201,140,341
"15357",1604,1435,1572,108,90,198
"15358",2241,2113,1577,120,123,243
"15359",2108,2002,1582,51,62,113
"15360",2319,1955,1586,71,65,136
"15361",2042,1646,1587,224,226,450
"15362",21,2106,1588,100,106,206
"15363",2120,2011,1602,50,51,101
"15364",32,2222,1616,54,77,131
"15365",1501,1253,1629,106,73,179
"15366",1703,1540,1639,75,55,130
"15367",1811,1436,1640,75,66,141
"15368",2258,1936,1648,228,231,459
"15369",1806,1611,1652,76,91,167
"15370",2002,1833,1653,165,173,338
"15371",2333,1923,1658,86,103,189
"15372",2347,2046,1661,41,51,92
"15373",1856,1514,1665,91,72,163
"15374",2339,1924,1676,201,204,405
"15375",33,2023,1678,57,75,132
"15376",1616,1345,1680,66,45,111
"15377",39,2351,1687,149,161,310
"15378",2232,1823,1688,155,148,303
"15379",958,854,1697,81,89,170
"15380",2106,2018,1707,114,123,237
"15381",2038,1942,1709,106,112,218
"15382",2039,1849,1711,227,244,471
"15383",13,2036,1730,60,73,133
"15384",2210,1821,1742,231,226,457
"15385",2003,1648,1089,58,58,116
"15386",2144,1721,1546,82,91,173
"15387",1738,1428,1553,34,43,77
"15388",1618,1101,1573,43,42,85
"15389",1809,1657,1628,113,122,235
"15390",1215,1115,1677,124,125,249
"15391",1214,955,1714,64,45,109
"15392",1738,1348,1744,37,38,75
"15393",2158,2030,47,72,80,152
"15394",1945,1627,1089,37,37,74
"15395",2310,1923,1235,32,33,65
"15396",1348,1246,1520,47,61,108
"15397",2107,1633,1546,40,43,83
"15398",3,2009,1730,50,46,96
"15399",2109,1947,59,109,117,226
"15400",1730,1602,1008,90,97,187
"15401",2114,1953,1019,49,53,102
"15402",2226,1951,1091,63,61,124
"15403",1221,824,1279,48,69,117
"15404",2304,2148,1597,32,43,75
"15405",1029,926,1624,32,36,68
"15406",2250,2158,1687,40,48,88
"15407",2001,1812,1250,48,32,80
"15408",2303,2149,1259,34,34,68
"15409",1131,1032,1677,77,82,159
"15410",2310,1943,1706,39,48,87
"15411",102,2129,1730,109,126,235
"15412",1728,1523,1652,38,43,81
"15413",1557,1402,1680,47,62,109
"15414",1825,1400,60,115,120,235
"15415",2259,2041,1033,118,106,224
"15416",2036,1828,1132,32,43,75
"15417",1930,1620,1148,160,170,330
"15418",1850,1415,1162,65,65,130
"15419",1617,1103,1573,39,44,83
"15420",1754,1540,1652,64,60,124
"15421",1556,1405,1680,46,65,111
"15422",2335,2125,1712,37,35,72
"15423",2355,1957,1730,42,34,76
"15424",2148,1925,1198,65,68,133
"15425",1607,1148,1243,91,88,179
"15426",33,1955,1268,46,50,96
"15427",1432,1317,1273,36,37,73
"15428",48,2247,1401,112,117,229
"15429",2301,2151,1406,40,61,101
"15430",1550,1150,1444,40,35,75
"15431",117,2252,1514,108,117,225
"15432",2130,1651,1546,63,61,124
"15433",1451,1347,1572,35,42,77
"15434",2042,1638,1606,39,33,72
"15435",2025,1916,5,82,81,163
"15436",1828,1729,33,108,119,227
"15437",1934,1519,62,40,54,94
"15438",2322,2215,1019,62,75,137
"15439",1502,1112,1085,76,62,138
"15440",1548,1201,1116,79,86,165
"15441",1133,837,1161,41,62,103
"15442",1816,1343,1162,36,33,69
"15443",2057,1644,1546,35,54,89
"15444",1743,1427,1569,49,67,116
"15445",2139,1739,1638,42,39,81
"15446",2009,1712,2126,54,63,117
"15447",2019,1706,8,98,91,189
"15448",2229,1932,54,108,116,224
"15449",1633,1311,1672,58,43,101
"15450",2022,1710,2126,67,61,128
"15451",2047,1744,8,126,129,255
"15452",1223,925,1884,203,215,418
"15453",1719,1423,1675,51,58,109
"15454",1637,1557,2511,32,37,69
"15455",1904,1729,37,44,34,78
"15456",1832,1740,2086,32,40,72
"15457",1044,931,243,64,71,135
"15458",2334,2245,1344,39,55,94
"15459",1832,1743,2189,37,43,80
"15460",1743,1611,1980,38,41,79
"15461",2223,2115,2250,78,95,173
"15462",2110,1815,1466,35,50,85
"15463",1800,1647,31,80,77,157
"15464",2044,1942,1183,69,72,141
"15465",1846,1751,1685,61,51,112
"15466",1740,1629,2511,95,69,164
"15467",1339,1205,1343,39,35,74
"15468",2317,2147,2029,47,67,114
"15469",2350,2203,190,75,78,153
"15470",1344,1146,198,84,71,155
"15471",1836,1627,509,76,52,128
"15472",145,2156,2061,140,146,286
"15473",2132,1707,2192,107,77,184
"15474",1239,1141,11,49,46,95
"15475",2033,1943,39,133,133,266
"15476",1733,1634,34,118,124,242
"15477",1914,1801,36,194,181,375
"15478",1800,1654,38,85,84,169
"15479",1831,1730,40,91,90,181
"15480",1830,1718,42,60,48,108
"15481",1848,1736,44,48,36,84
"15482",1952,1831,46,82,61,143
"15483",2152,2059,56,57,59,116
"15484",2310,2225,60,60,85,145
"15485",2047,1930,1592,57,65,122
"15486",1951,1828,1670,191,193,384
"15487",1933,1751,1637,73,56,129
"15488",1840,1748,2154,45,48,93
"15489",1614,1517,2622,114,112,226
"15490",2038,1610,1082,73,75,148
"15491",1555,1044,2341,85,44,129
"15492",1358,1040,7,33,35,68
"15493",118,2202,287,103,117,220
"15494",1458,1335,1153,108,85,193
"15495",1332,1210,1293,72,50,122
"15496",2020,1917,2086,140,137,277
"15497",1631,1516,2307,66,61,127
"15498",1327,1211,15,37,36,73
"15499",2114,2019,2604,49,64,113
"15500",2135,2005,1057,55,65,120
"15501",1836,1704,1508,56,54,110
"15502",1924,1751,312,64,51,115
"15503",2323,2017,274,68,77,145
"15504",1944,1708,1659,59,48,107
"15505",1655,1404,1952,75,49,124
"15506",1254,1147,167,74,72,146
"15507",2041,1945,2219,36,40,76
"15508",2305,2207,3220,85,87,172
"15509",1921,1719,2261,46,49,95
"15510",2020,1912,206,315,322,637
"15511",1823,1701,3927,63,61,124
"15512",1308,1218,554,38,38,76
"15513",2104,2027,1449,34,42,76
"15514",1724,1615,1495,94,75,169
"15515",1923,1755,2396,103,95,198
"15516",1617,1516,249,62,56,118
"15517",1921,1831,2189,86,91,177
"15518",1901,1647,33,66,42,108
"15519",2246,1947,43,61,72,133
"15520",2149,2040,767,64,85,149
"15521",1750,1628,1197,70,73,143
"15522",2037,1947,46,127,137,264
"15523",2041,1948,50,76,78,154
"15524",2057,1947,45,32,32,64
"15525",2114,1947,1057,34,47,81
"15526",1959,1804,2261,84,94,178
"15527",2009,1904,1183,34,34,68
"15528",1256,1122,198,36,47,83
"15529",1449,1409,1185,99,104,203
"15530",1040,935,12,40,35,75
"15531",1502,1346,28,67,46,113
"15532",1907,1817,42,97,107,204
"15533",1752,1616,2470,72,61,133
"15534",1459,1414,2622,39,49,88
"15535",1618,1200,2341,108,120,228
"15536",1358,1054,7,33,49,82
"15537",1145,847,1628,50,67,117
"15538",1614,1403,1952,34,48,82
"15539",1534,1441,286,34,41,75
"15540",2247,1959,43,62,84,146
"15541",2350,2226,2029,80,106,186
"15542",1931,1836,48,31,36,67
"15543",2126,1713,1082,121,138,259
"15544",1605,1111,2341,95,71,166
"15545",1835,1735,2086,35,35,70
"15546",2120,1953,1057,40,53,93
"15547",1915,1800,1681,55,60,115
"15548",16,2158,663,36,43,79
"15549",2216,2117,3220,36,37,73
"15550",1731,1606,1197,51,51,102
"15551",1527,1112,2341,57,72,129
"15552",1545,1451,2212,50,56,106
"15553",1341,1206,1343,41,36,77
"15554",1517,1052,2341,47,52,99
"15555",2237,2133,1688,37,53,90
"15556",2225,2133,1616,50,58,108
"15557",1639,1516,2103,49,46,95
"15558",2228,2131,3220,48,51,99
"15559",1333,1220,3307,33,35,68
"15560",2204,2023,2134,79,68,147
"15561",1916,1813,2086,76,73,149
"15562",1227,1119,183,37,44,81
"15563",2038,1924,1183,63,54,117
"15564",1419,1333,1185,69,68,137
"15565",1653,1342,2878,38,42,80
"15566",809,707,2,44,37,81
"15567",835,731,4,40,31,71
"15568",2055,1959,50,90,89,179
"15569",2023,1535,1082,58,40,98
"15570",2108,1953,45,43,38,81
"15571",2115,1939,1057,35,39,74
"15572",1933,1836,3869,78,86,164
"15573",1034,910,243,54,50,104
"15574",1827,1708,3927,67,68,135
"15575",1913,1512,3937,133,147,280
"15576",1916,1830,2189,81,90,171
"15577",2345,2153,706,95,98,193
"15578",2247,2006,43,62,91,153
"15579",2011,1928,1699,41,43,84
"15580",1820,1740,2493,35,40,75
"15581",2309,2223,491,89,108,197
"15582",1902,1802,44,62,62,124
"15583",2006,1909,48,66,69,135
"15584",2018,1922,50,53,52,105
"15585",2254,2202,60,44,62,106
"15586",1716,1549,2470,36,34,70
"15587",2019,1610,1082,54,75,129
"15588",1907,1811,2086,67,71,138
"15589",1907,1704,2261,32,34,66
"15590",1347,1226,3307,47,41,88
"15591",859,802,419,54,47,101
"15592",1830,1711,2396,50,51,101
"15593",1156,910,201,71,80,151
"15594",18,2136,873,33,56,89
"15595",2141,2018,2134,56,63,119
"15596",1734,1630,31,54,60,114
"15597",1232,1136,11,42,41,83
"15598",1919,1829,39,59,59,118
"15599",1706,1605,38,31,35,66
"15600",2120,2026,52,80,86,166
"15601",1626,1512,2622,126,107,233
"15602",9,2103,287,34,58,92
"15603",1534,1442,165,34,42,76
"15604",1335,1222,3307,35,37,72
"15605",1555,1502,249,40,42,82
"15606",2010,1927,316,35,57,92
"15607",1717,1532,670,47,57,104
"15608",2026,1904,1592,36,39,75
"15609",1537,1443,165,37,43,80
"15610",2209,2116,1616,34,41,75
"15611",1910,1757,312,50,57,107
"15612",8,2305,1183,273,275,548
"15613",1817,1740,2493,32,40,72
"15614",1813,1631,509,53,56,109
"15615",2017,1627,2192,32,37,69
"15616",1602,1520,23,112,120,232
"15617",1924,1836,39,64,66,130
"15618",2215,2128,491,35,53,88
"15619",1243,1124,12,163,144,307
"15620",1207,1107,14,92,97,189
"15621",1228,1116,16,83,76,159
"15622",1337,1141,20,102,41,143
"15623",1348,1250,24,48,50,98
"15624",1733,1644,32,153,164,317
"15625",1638,1534,34,63,64,127
"15626",1633,1535,36,33,35,68
"15627",1841,1748,40,101,108,209
"15628",2043,1944,46,133,134,267
"15629",1723,1543,21,168,163,331
"15630",2038,1953,2154,163,173,336
"15631",2111,1657,1082,106,122,228
"15632",11,2055,287,36,50,86
"15633",1504,1414,3,309,319,628
"15634",1347,1300,3135,37,50,87
"15635",2259,2152,3410,59,72,131
"15636",1659,1539,15,249,244,493
"15637",2325,2027,274,70,87,157
"15638",1931,1712,184,36,42,78
"15639",1221,1125,167,41,50,91
"15640",1708,1606,286,128,126,254
"15641",2040,1943,2219,35,38,73
"15642",2221,2122,3220,41,42,83
"15643",1918,1714,2261,43,44,87
"15644",1536,1425,206,31,35,66
"15645",2046,1653,3937,226,248,474
"15646",1301,1219,554,31,39,70
"15647",1902,1821,1495,192,201,393
"15648",2326,2242,1344,31,52,83
"15649",1925,1734,33,90,89,179
"15650",35,2141,873,50,61,111
"15651",1635,1338,1372,145,148,293
"15652",2053,1932,1197,253,257,510
"15653",2351,2216,931,31,61,92
"15654",1502,1408,30,32,38,70
"15655",2133,1721,1082,128,146,274
"15656",1335,1225,15,45,50,95
"15657",1946,1730,184,51,60,111
"15658",2212,1929,397,62,44,106
"15659",1541,1446,286,41,46,87
"15660",1807,1654,3927,47,54,101
"15661",1124,829,201,39,39,78
"15662",1515,1227,1372,65,77,142
"15663",1711,1606,31,31,36,67
"15664",2101,1958,1183,86,88,174
"15665",1925,1834,2154,90,94,184
"15666",1606,1504,2307,41,49,90
"15667",2102,1946,45,37,31,68
"15668",2111,1931,1057,31,31,62
"15669",2251,1937,274,36,37,73
"15670",2106,1841,2261,151,131,282
"15671",1446,1247,2508,31,42,73
"15672",1712,1632,2511,67,72,139
"15673",1831,1738,36,151,158,309
"15674",1857,1735,37,37,40,77
"15675",2251,1847,1082,206,232,438
"15676",1532,1133,2341,62,93,155
"15677",2322,2228,55,47,63,110
"15678",1819,1653,1508,39,43,82
"15679",1714,1508,1952,94,113,207
"15680",1211,1107,167,31,32,63
"15681",2159,1945,2261,204,195,399
"15682",2326,2235,1344,31,45,76
"15683",11,2112,43,146,157,303
"15684",1125,1013,1653,55,53,108
"15685",1635,1539,36,35,39,74
"15686",2037,1947,2154,162,167,329
"15687",1842,1742,2086,42,42,84
"15688",1801,1642,2103,131,132,263
"15689",1917,1700,1952,217,225,442
"15690",1847,1743,3869,32,33,65
"15691",1920,1715,2261,45,45,90
"15692",1349,1232,3307,49,47,96
"15693",2026,1620,3937,206,215,421
"15694",1815,1653,2396,35,33,68
"15695",1246,1144,2030,31,39,70
"15696",1953,1909,1070,38,44,82
"15697",1651,1607,1789,31,32,63
"15698",2057,1719,2127,97,119,216
"15699",1549,1504,3318,34,39,73
"15700",1754,1636,1980,49,66,115
"15701",1801,1709,2282,91,94,185
"15702",2229,1922,1133,34,47,81
"15703",2043,1932,614,63,72,135
"15704",1502,1326,3185,37,36,73
"15705",1412,1007,1875,47,52,99
"15706",1528,1438,2445,43,43,86
"15707",1207,1118,2792,37,38,75
"15708",2050,1923,1592,60,58,118
"15709",2021,1554,1082,56,59,115
"15710",14,2325,1616,159,170,329
"15711",1841,1747,2086,41,47,88
"15712",1939,1821,312,79,81,160
"15713",1909,1714,2261,34,44,78
"15714",1831,1434,3937,91,109,200
"15715",1713,1607,31,33,37,70
"15716",1847,1756,44,47,56,103
"15717",2002,1908,50,37,38,75
"15718",2051,1953,52,51,53,104
"15719",1138,1040,3,103,105,208
"15720",1834,1705,1508,54,55,109
"15721",18,2118,51,33,38,71
"15722",839,746,362,39,46,85
"15723",1516,1313,2508,61,68,129
"15724",1406,1253,3307,66,68,134
"15725",2325,1945,4090,408,400,808
"15726",1738,1406,4090,61,61,122
"15727",1726,1359,4090,49,54,103
"15728",1743,1408,4090,66,63,129
"15729",1746,1422,4092,31,39,70
"15730",2034,1703,4092,199,200,399
"15731",1232,1118,4094,115,108,223
"15732",1110,1015,4094,31,45,76
"15733",1154,830,4095,50,65,115
"15734",1721,1558,4095,58,53,111
"15735",1710,1553,4095,47,48,95
"15736",1716,1556,4095,53,51,104
"15737",1703,1537,4095,40,32,72
"15738",1246,1148,4099,130,128,258
"15739",2231,2117,4100,76,72,148
"15740",158,2253,4105,142,152,294
"15741",9,2102,4105,33,41,74
"15742",1823,1652,4107,45,47,92
"15743",1850,1729,4110,81,89,170
"15744",2149,1835,4115,61,50,111
"15745",2255,2016,4115,33,41,74
"15746",13,2051,4119,68,54,122
"15747",2302,2123,4120,70,88,158
"15748",2251,2103,4120,61,68,129
"15749",7,2159,4120,135,124,259
"15750",25,2340,4125,40,40,80
"15751",1802,1537,4132,77,62,139
"15752",1922,1718,4132,157,163,320
"15753",1733,1516,4132,48,41,89
"15754",2109,1803,4134,100,98,198
"15755",1415,1207,4136,83,72,155
"15756",1555,1240,4137,159,150,309
"15757",1409,1108,4137,53,58,111
"15758",1550,1256,4140,115,91,206
"15759",1640,1513,4144,122,128,250
"15760",2040,1917,4146,48,57,105
"15761",2115,1943,4146,83,83,166
"15762",2135,1954,4146,103,94,197
"15763",2054,1914,4146,62,54,116
"15764",2146,2041,4147,82,86,168
"15765",2108,2009,4147,44,54,98
"15766",2116,2018,4147,52,63,115
"15767",2359,2045,4149,57,60,117
"15768",138,2357,4149,244,272,516
"15769",2055,1906,4157,95,96,191
"15770",2008,1825,4157,48,55,103
"15771",1549,1423,4159,86,88,174
"15772",1507,1332,4159,44,37,81
"15773",1621,1431,4159,118,96,214
"15774",2128,2005,4161,264,270,534
"15775",1840,1718,4161,96,103,199
"15776",16,2113,4161,111,118,229
"15777",2138,1819,4165,248,239,487
"15778",1338,1158,4172,39,36,75
"15779",44,4,4174,59,64,123
"15780",1242,1127,4180,77,82,159
"15781",1351,1230,4180,144,145,289
"15782",2000,1633,4183,144,138,282
"15783",1852,1542,4183,76,87,163
"15784",1054,939,4188,35,49,84
"15785",2328,2141,4189,183,166,349
"15786",2104,1933,4189,39,38,77
"15787",2112,1952,4189,47,57,104
"15788",1201,1046,4189,39,41,80
"15789",2126,1828,4190,106,113,219
"15790",2115,1826,4190,95,111,206
"15791",2228,1914,4190,168,159,327
"15792",2047,1742,4190,67,67,134
"15793",1305,1134,4193,167,139,306
"15794",2016,1914,4197,90,89,179
"15795",1555,1232,4202,79,62,141
"15796",1553,1243,4202,77,73,150
"15797",2051,1857,4202,91,87,178
"15798",1557,1429,4208,105,84,189
"15799",1518,1423,4208,66,78,144
"15800",1040,924,4210,107,114,221
"15801",1355,1104,4215,31,54,85
"15802",2259,2207,4216,38,47,85
"15803",2311,2217,4216,50,57,107
"15804",1705,1513,4221,67,43,110
"15805",2044,1737,4223,236,242,478
"15806",1408,1250,4226,315,320,635
"15807",1559,1500,4231,43,45,88
"15808",30,2301,4232,105,101,206
"15809",951,749,4232,67,34,101
"15810",1217,1050,4234,43,45,88
"15811",35,2058,4243,75,76,151
"15812",44,2112,4243,84,90,174
"15813",203,2243,4243,163,181,344
"15814",8,2037,4243,48,55,103
"15815",2354,2033,4243,36,51,87
"15816",50,2120,4243,90,98,188
"15817",2141,2025,4243,51,43,94
"15818",1821,1708,4246,47,48,95
"15819",933,821,4249,47,56,103
"15820",18,2333,4252,33,33,66
"15821",2128,1935,4259,299,305,604
"15822",1701,1514,4259,32,44,76
"15823",13,2054,4261,246,249,495
"15824",1329,1227,4262,55,62,117
"15825",1421,1316,4262,107,111,218
"15826",1336,1230,4262,62,65,127
"15827",1624,1456,4263,40,36,76
"15828",1903,1657,4263,83,87,170
"15829",2155,1935,4263,255,245,500
"15830",1829,1616,4263,49,46,95
"15831",2215,2047,4265,82,82,164
"15832",2130,2010,4265,37,45,82
"15833",2144,2023,4265,51,58,109
"15834",2136,2018,4265,43,53,96
"15835",2138,2013,4265,45,48,93
"15836",2242,2120,4265,79,85,164
"15837",2227,2103,4265,94,98,192
"15838",2142,2028,4265,49,63,112
"15839",1246,1135,4268,57,38,95
"15840",1245,1145,4268,56,48,104
"15841",1221,1134,4268,32,37,69
"15842",1240,1156,4268,53,59,112
"15843",41,2243,4269,146,158,304
"15844",2310,2054,4269,55,49,104
"15845",1242,909,4274,80,69,149
"15846",1349,1049,4275,35,39,74
"15847",1250,1127,4281,80,82,162
"15848",1211,1041,4281,41,36,77
"15849",117,2213,4282,146,159,305
"15850",1301,1150,4282,170,170,340
"15851",1048,941,4282,37,41,78
"15852",2048,1733,4283,122,123,245
"15853",1449,1342,4289,39,47,86
"15854",1441,1328,4289,31,33,64
"15855",1319,1133,4292,116,126,242
"15856",1202,1007,4292,51,52,103
"15857",2035,1927,4293,266,267,533
"15858",1758,1649,4293,89,89,178
"15859",1702,1601,4293,33,41,74
"15860",1844,1523,4302,57,63,120
"15861",1859,1528,4302,72,68,140
"15862",1818,1500,4302,31,40,71
"15863",2326,2155,4309,153,160,313
"15864",2222,2053,4309,89,98,187
"15865",2217,2039,4309,84,84,168
"15866",2333,2040,4314,60,75,135
"15867",2316,2024,4314,43,59,102
"15868",1810,1653,4314,76,79,155
"15869",1730,1624,4315,78,79,157
"15870",1827,1721,4315,135,136,271
"15871",1613,1442,4315,109,112,221
"15872",2022,1720,4319,177,180,357
"15873",1443,1349,4323,116,119,235
"15874",1458,1145,4325,47,50,97
"15875",1233,1116,4326,203,201,404
"15876",953,850,4326,48,60,108
"15877",1818,1701,4329,54,53,107
"15878",1813,1702,4329,49,54,103
"15879",1906,1755,4329,102,107,209
"15880",1810,1640,4329,46,32,78
"15881",2018,1705,4330,49,40,89
"15882",2030,1731,4330,61,66,127
"15883",2024,1731,4330,55,66,121
"15884",2122,1805,4330,113,100,213
"15885",1846,1708,4331,71,78,149
"15886",1851,1701,4331,76,71,147
"15887",1829,1650,4331,54,60,114
"15888",1920,1740,4331,105,110,215
"15889",55,2324,4336,196,199,395
"15890",2351,2221,4336,97,101,198
"15891",2231,2059,4336,52,54,106
"15892",1515,1346,4341,43,51,94
"15893",1510,1338,4341,38,43,81
"15894",1621,1440,4341,111,105,216
"15895",1536,1339,4341,64,44,108
"15896",2315,2218,4342,40,53,93
"15897",957,821,4343,51,51,102
"15898",2021,1825,4346,51,50,101
"15899",2125,2006,4350,54,56,110
"15900",2150,2052,4354,73,92,165
"15901",1939,1638,4356,34,33,67
"15902",2137,1836,4356,152,151,303
"15903",2156,1857,4356,171,172,343
"15904",1420,1316,4357,79,81,160
"15905",1354,1238,4357,51,43,94
"15906",1227,913,4357,38,33,71
"15907",2023,1846,4361,36,41,77
"15908",2117,1910,4361,90,65,155
"15909",2012,1703,4365,197,197,394
"15910",2215,1903,4365,320,317,637
"15911",1802,1500,4365,67,74,141
"15912",1537,1205,4371,78,75,153
"15913",2014,1835,4372,51,50,101
"15914",2336,2151,4372,253,246,499
"15915",1122,942,4384,42,42,84
"15916",2252,2123,4385,73,78,151
"15917",2207,2034,4385,122,129,251
"15918",2038,1901,4385,33,36,69
"15919",1736,1647,4388,54,62,116
"15920",1929,1629,4390,125,134,259
"15921",1705,1452,4391,103,32,135
"15922",1957,1817,4392,34,32,66
"15923",1551,1455,4392,168,165,333
"15924",1434,1317,4392,116,92,208
"15925",2250,2200,4394,58,60,118
"15926",1633,1514,4395,111,119,230
"15927",1910,1730,4396,187,185,372
"15928",2104,1929,4396,301,304,605
"15929",1218,1058,4399,50,53,103
"15930",1332,1235,4402,43,45,88
"15931",1412,1319,4402,83,89,172
"15932",1537,1357,4402,170,127,297
"15933",2224,2139,4403,142,149,291
"15934",2226,2129,4403,144,139,283
"15935",1623,1534,4403,66,69,135
"15936",1657,1556,4403,100,91,191
"15937",3,2055,4405,70,81,151
"15938",1442,1127,4407,46,42,88
"15939",1544,1239,4407,108,114,222
"15940",1927,1829,4408,52,49,101
"15941",1920,1825,4408,45,45,90
"15942",2011,1912,4410,36,47,83
"15943",2158,2050,4410,136,140,276
"15944",1704,1541,4412,79,86,165
"15945",1623,1452,4412,38,37,75
"15946",2344,2043,4414,31,38,69
"15947",1622,1332,4414,215,127,342
"15948",1628,1534,4417,69,69,138
"15949",1605,1520,4417,46,55,101
"15950",1931,1820,4417,252,235,487
"15951",1642,1538,4417,83,73,156
"15952",1715,1619,4417,116,114,230
"15953",1406,1242,4418,72,77,149
"15954",1537,1312,4418,165,107,272
"15955",1459,1321,4418,125,116,241
"15956",1331,1212,4419,118,127,245
"15957",1502,1320,4419,209,195,404
"15958",2102,1714,4425,63,64,127
"15959",932,802,4426,32,32,64
"15960",943,809,4426,43,39,82
"15961",1755,1659,4427,81,79,160
"15962",1713,1618,4427,39,38,77
"15963",1735,1647,4427,61,67,128
"15964",2138,1809,4431,258,249,507
"15965",2105,2019,4432,317,329,646
"15966",1638,1522,4432,50,32,82
"15967",1636,1535,4432,48,45,93
"15968",26,2339,4435,40,44,84
"15969",2216,2114,4436,99,114,213
"15970",2117,2010,4436,40,50,90
"15971",1245,1137,4438,144,147,291
"15972",1108,1006,4438,47,56,103
"15973",1231,1125,4446,60,70,130
"15974",1827,1707,4448,150,162,312
"15975",1644,1522,4448,47,57,104
"15976",1735,1602,4448,98,97,195
"15977",2012,1851,4450,153,156,309
"15978",1814,1657,4450,35,42,77
"15979",1910,1737,4450,91,82,173
"15980",1833,1721,4452,57,61,118
"15981",1954,1841,4452,116,119,235
"15982",1811,1701,4452,35,41,76
"15983",1842,1729,4452,31,34,65
"15984",1645,1357,4453,44,42,86
"15985",1024,930,4454,68,75,143
"15986",2400,2105,4456,121,125,246
"15987",2304,2003,4456,65,63,128
"15988",2400,2101,4456,121,121,242
"15989",1917,1605,4457,121,110,231
"15990",1812,1507,4457,56,52,108
"15991",1831,1536,4457,75,81,156
"15992",1854,1710,4459,88,100,188
"15993",1803,1618,4459,37,48,85
"15994",1727,1357,4462,57,37,94
"15995",2118,2019,4466,52,54,106
"15996",2123,2034,4466,57,69,126
"15997",2102,2009,4466,36,44,80
"15998",2154,2101,4466,88,96,184
"15999",1249,1129,4467,65,59,124
"16000",1602,1423,4469,112,93,205
"16001",2146,1810,4473,98,88,186
"16002",2147,1808,4473,99,86,185
"16003",2342,2022,4473,221,227,448
"16004",8,2026,4475,83,86,169
"16005",39,2058,4475,114,118,232
"16006",2334,2003,4475,54,68,122
"16007",2340,1944,4475,55,44,99
"16008",245,2314,4475,240,254,494
"16009",2122,1743,4477,119,118,237
"16010",2103,1732,4477,91,98,189
"16011",2103,1755,4481,56,60,116
"16012",2102,1745,4481,55,50,105
"16013",2037,1736,4481,32,41,73
"16014",2001,1803,4482,166,153,319
"16015",2054,1955,4485,56,50,106
"16016",1425,1335,4486,108,112,220
"16017",1355,1300,4486,76,77,153
"16018",1500,1301,4487,55,49,104
"16019",1851,1703,4487,286,291,577
"16020",1921,1750,4491,96,100,196
"16021",2135,2010,4491,230,240,470
"16022",1552,1341,4492,178,166,344
"16023",2224,2032,4494,270,277,547
"16024",1841,1638,4494,47,43,90
"16025",2121,2002,4496,203,207,410
"16026",1829,1721,4496,31,46,77
"16027",1424,1240,4565,183,180,363
"16028",1704,1510,4566,99,100,199
"16029",1237,1144,4569,46,49,95
"16030",1324,1228,4569,91,93,184
"16031",1648,1540,4569,34,35,69
"16032",24,2312,4577,187,187,374
"16033",2154,2042,4577,37,37,74
"16034",1539,1210,4578,83,70,153
"16035",1248,1118,4579,87,98,185
"16036",2111,2002,4581,49,37,86
"16037",2157,2102,4581,95,97,192
"16038",2154,2104,4581,62,69,131
"16039",19,2113,4583,114,118,232
"16040",1224,1125,4584,38,40,78
"16041",1711,1619,4586,40,44,84
"16042",1847,1752,4586,134,137,271
"16043",1907,1806,4586,154,151,305
"16044",1743,1653,4586,70,78,148
"16045",1808,1700,4587,112,115,227
"16046",157,2255,4589,157,170,327
"16047",25,2059,4589,65,54,119
"16048",2359,2052,4589,39,47,86
"16049",2157,2044,4592,40,39,79
"16050",2302,2151,4592,105,106,211
"16051",2258,1957,4593,36,37,73
"16052",2309,2011,4593,47,51,98
"16053",9,2059,4593,107,99,206
"16054",2142,2038,4594,189,182,371
"16055",1523,1409,4596,73,79,152
"16056",1740,1320,4597,209,143,352
"16057",1512,1152,4597,61,55,116
"16058",1110,851,4598,42,61,103
"16059",1319,1128,4605,45,53,98
"16060",1807,1512,4607,94,102,196
"16061",1802,1503,4607,89,93,182
"16062",1807,1512,4607,94,102,196
"16063",1815,1515,4607,102,105,207
"16064",1324,1143,4615,91,98,189
"16065",1228,1037,4615,35,32,67
"16066",2254,2159,4619,46,44,90
"16067",2253,2203,4619,45,48,93
"16068",1,2031,4626,164,161,325
"16069",2259,1942,4626,102,112,214
"16070",2238,1908,4626,81,78,159
"16071",1752,1611,4630,43,31,74
"16072",2351,2247,4631,96,97,193
"16073",31,2339,4632,36,44,80
"16074",243,140,4632,168,165,333
"16075",945,830,4632,52,60,112
"16076",2112,1837,4635,168,167,335
"16077",1916,1637,4635,50,45,95
"16078",1746,1643,4636,85,88,173
"16079",1916,1808,4636,175,173,348
"16080",1222,901,4640,43,41,84
"16081",1655,1538,4640,140,153,293
"16082",1926,1803,4640,291,298,589
"16083",1540,1421,4640,65,76,141
"16084",2024,1915,4641,67,70,137
"16085",1618,1340,4642,153,130,283
"16086",1539,1416,4646,64,71,135
"16087",1516,1359,4646,41,54,95
"16088",1625,1326,4646,174,176,350
"16089",1225,1130,4657,34,35,69
"16090",2309,2207,4658,44,52,96
"16091",2234,1953,4658,34,38,72
"16092",2328,2059,4658,86,104,190
"16093",2310,2039,4658,68,84,152
"16094",2341,2104,4658,99,109,208
"16095",2146,2117,4660,201,197,398
"16096",2119,2040,4660,174,160,334
"16097",1900,1834,4660,35,34,69
"16098",1818,1642,4661,49,42,91
"16099",1814,1653,4661,45,53,98
"16100",1941,1824,4661,132,144,276
"16101",1300,1137,4664,87,87,174
"16102",1710,1412,4667,165,97,262
"16103",1710,1545,4669,108,80,188
"16104",1806,1702,4669,164,157,321
"16105",2227,2049,4674,42,49,91
"16106",1428,1107,4676,40,32,72
"16107",2232,2145,4677,36,40,76
"16108",1604,1535,4678,39,50,89
"16109",1754,1730,4678,149,165,314
"16110",957,805,4679,32,35,67
"16111",1900,1744,4681,55,59,114
"16112",2041,1910,4684,69,75,144
"16113",2121,1941,4684,109,106,215
"16114",2102,1932,4684,90,97,187
"16115",1657,1351,4685,49,61,110
"16116",1534,1440,4687,52,55,107
"16117",1558,1501,4687,76,76,152
"16118",2257,2110,4692,90,100,190
"16119",2327,2128,4692,120,118,238
"16120",2212,2004,4692,45,34,79
"16121",2228,2032,4692,61,62,123
"16122",1726,1354,4694,43,59,102
"16123",1807,1414,4694,84,79,163
"16124",1659,1525,4698,150,150,300
"16125",1550,1420,4698,83,85,168
"16126",2330,2235,4702,142,155,297
"16127",1215,839,4708,70,84,154
"16128",2113,1952,4710,42,42,84
"16129",2126,2001,4710,55,51,106
"16130",1715,1321,4711,172,166,338
"16131",1838,1747,4712,118,122,240
"16132",1716,1625,4712,34,40,74
"16133",1901,1805,4712,137,138,275
"16134",1554,1407,6175,251,242,493
"16135",1228,1103,6175,44,50,94
"16136",1723,1511,4497,48,49,97
"16137",919,645,5422,48,45,93
"16138",2145,1958,4455,43,73,116
"16139",2214,2014,4455,72,89,161
"16140",53,2113,5158,79,88,167
"16141",1212,1112,5159,116,127,243
"16142",2052,1920,5161,132,110,242
"16143",1935,1842,5161,57,72,129
"16144",1340,1209,5166,125,144,269
"16145",2041,1733,5170,178,193,371
"16146",1508,1152,5172,79,87,166
"16147",1446,1133,5173,40,68,108
"16148",1837,1531,5177,45,46,91
"16149",1844,1541,5177,52,56,108
"16150",1922,1617,5177,90,92,182
"16151",1856,1538,5177,64,53,117
"16152",2104,1738,5181,42,38,80
"16153",2057,1749,5181,35,49,84
"16154",2202,1834,5182,104,114,218
"16155",1459,1353,5183,39,48,87
"16156",1909,1537,5185,95,82,177
"16157",1039,942,5187,53,52,105
"16158",1039,948,5187,53,58,111
"16159",1110,1042,5189,85,92,177
"16160",1053,1012,5189,68,62,130
"16161",1936,1855,5190,55,65,120
"16162",1359,1015,5193,145,165,310
"16163",2338,1931,5194,38,31,69
"16164",1909,1850,5197,63,75,138
"16165",1902,1830,5197,54,55,109
"16166",1849,1813,5197,41,38,79
"16167",1902,1833,5197,54,58,112
"16168",1605,1415,5200,42,45,87
"16169",1201,1040,5208,37,35,72
"16170",1358,1235,5208,154,150,304
"16171",1335,1219,5208,131,134,265
"16172",2242,2009,5209,234,254,488
"16173",1752,1627,5209,57,52,109
"16174",1756,1629,5209,61,54,115
"16175",1620,1422,5214,59,72,131
"16176",1213,1058,5216,114,118,232
"16177",1055,946,5216,36,46,82
"16178",1725,1516,5226,38,41,79
"16179",2227,2025,5227,80,90,170
"16180",2324,2119,5227,137,144,281
"16181",1946,1824,5228,42,44,86
"16182",2204,2030,5228,180,170,350
"16183",2028,1906,5228,84,86,170
"16184",1551,1509,5240,126,134,260
"16185",1615,1423,5240,50,53,103
"16186",2236,2045,5241,62,80,142
"16187",2235,2009,5241,61,44,105
"16188",1911,1735,5253,186,170,356
"16189",1803,1709,5257,86,94,180
"16190",2131,2034,5257,181,184,365
"16191",1319,1221,5267,53,56,109
"16192",2357,2140,230,237,246,483
"16193",2050,1815,230,50,41,91
"16194",1046,837,404,44,36,80
"16195",1907,1517,552,82,87,169
"16196",1923,1428,552,98,38,136
"16197",1555,1434,737,93,94,187
"16198",1735,1553,737,193,173,366
"16199",1622,1447,737,120,107,227
"16200",1500,1335,737,38,35,73
"16201",1521,1404,737,59,64,123
"16202",1230,1017,855,70,63,133
"16203",1232,1028,855,72,74,146
"16204",1245,1045,855,85,91,176
"16205",1019,654,996,98,99,197
"16206",1300,927,1696,150,147,297
"16207",2238,1835,1828,38,50,88
"16208",1606,1239,1702,40,39,79
"16209",1855,1445,1824,85,91,176
"16210",2200,1835,1679,53,55,108
"16211",2048,1642,1824,198,208,406
"16212",2244,1836,1828,44,51,95
"16213",24,2038,1828,144,173,317
"16214",1629,1553,409,42,53,95
"16215",2313,1850,1828,73,65,138
"16216",1943,1549,1824,133,155,288
"16217",1445,1130,1174,59,65,124
"16218",1825,1436,1824,59,81,140
"16219",1303,1130,1310,53,55,108
"16220",857,732,2227,32,32,64
"16221",900,803,2782,35,38,73
"16222",2240,2151,1616,65,76,141
"16223",1730,1508,1952,110,113,223
"16224",1451,1201,818,61,71,132
"16225",1831,1739,2086,31,39,70
"16226",2350,2137,397,160,172,332
"16227",57,2209,873,72,89,161
"16228",2325,2156,2029,55,76,131
"16229",2000,1842,1681,100,102,202
"16230",1744,1621,2470,64,66,130
"16231",2245,2150,3220,65,70,135
"16232",1833,1706,2396,53,46,99
"16233",2255,2156,60,45,56,101
"16234",122,31,55,167,186,353
"16235",155,105,1344,180,195,375
"16236",2157,1901,1164,47,56,103
"16237",2009,1713,2126,54,64,118
"16238",1358,1100,1590,86,90,176
"16239",2028,1730,2126,73,81,154
"16240",149,2310,1215,701,730,1431
"16241",2011,1702,2126,56,53,109
"16242",940,655,1884,40,65,105
"16243",1959,1642,2126,44,33,77
"16244",2126,1839,54,45,63,108
"16245",2119,1827,54,38,51,89
"16246",1756,1631,5220,253,266,519
"16247",1948,1810,5246,94,95,189
"16248",1937,1814,5246,83,99,182
"16249",1901,1727,5246,47,52,99
"16250",2027,1859,5246,133,144,277
"16251",1341,1003,5386,36,43,79
"16252",1937,1553,5412,53,57,110
"16253",1732,1409,5606,56,82,138
"16254",1403,1253,777,38,50,88
"16255",810,653,579,43,48,91
"16256",931,808,579,124,123,247
"16257",1709,1422,286,111,119,230
"16258",2027,1727,288,107,102,209
"16259",2019,1905,2870,39,35,74
"16260",1624,1436,2958,284,246,530
"16261",1224,1102,2958,44,32,76
"16262",1216,1110,2958,36,40,76
"16263",1143,1012,3210,78,57,135
"16264",1125,948,3210,60,33,93
"16265",1319,1129,3210,174,134,308
"16266",1410,1229,3216,70,39,109
"16267",828,717,3265,83,77,160
"16268",2123,2022,3328,43,47,90
"16269",2137,2036,3328,57,61,118
"16270",2049,1941,3390,284,286,570
"16271",1719,1616,3390,74,81,155
"16272",1652,1540,3390,47,45,92
"16273",1805,1654,3390,120,119,239
"16274",2316,2003,3717,136,98,234
"16275",2140,1925,3717,40,60,100
"16276",1528,1359,3719,88,94,182
"16277",1437,1304,3719,37,39,76
"16278",1520,1345,3719,80,80,160
"16279",2231,2108,3724,31,38,69
"16280",1521,1401,3762,346,356,702
"16281",1502,1333,3762,327,328,655
"16282",1923,1627,3786,53,37,90
"16283",1431,1213,3796,46,58,104
"16284",1001,717,3859,41,32,73
"16285",1858,1742,458,113,112,225
"16286",1611,1453,742,36,33,69
"16287",1654,1502,742,79,42,121
"16288",2224,1900,1294,94,95,189
"16289",2310,1954,1294,130,139,269
"16290",2134,1807,1294,34,32,66
"16291",1102,948,1788,42,43,85
"16292",1910,1752,1903,685,677,1362
"16293",2224,1938,731,62,68,130
"16294",2101,1639,622,42,47,89
"16295",2150,1736,622,93,106,199
"16296",2138,1700,622,81,70,151
"16297",1140,723,620,37,43,80
"16298",1800,1505,1151,74,95,169
"16299",1126,807,1160,38,37,75
"16300",2255,1940,1192,41,50,91
"16301",1907,1506,1439,55,36,91
"16302",1753,1313,1559,69,43,112
"16303",2040,1721,1606,79,86,165
"16304",2203,1945,1033,42,50,92
"16305",1824,1353,1087,46,58,104
"16306",2,1935,1100,46,37,83
"16307",2343,2225,1490,75,85,160
"16308",1746,1522,1501,111,127,238
"16309",2111,1834,1503,123,124,247
"16310",2113,1840,1511,246,250,496
"16311",2058,1622,1546,32,32,64
"16312",6,1945,1658,117,125,242
"16313",2116,1902,1659,32,31,63
"16314",2020,1743,1662,130,133,263
"16315",111,2112,1706,163,197,360
"16316",1250,935,1103,80,45,125
"16317",2150,1946,1181,113,131,244
"16318",2327,1928,1235,44,33,77
"16319",2342,1938,1268,39,48,87
"16320",2305,2132,1490,37,32,69
"16321",1904,1754,33,119,119,238
"16322",58,2159,1048,73,89,162
"16323",1829,1511,1151,103,101,204
"16324",2322,2009,1192,48,59,107
"16325",2157,1733,1202,83,103,186
"16326",2116,2028,1233,62,73,135
"16327",5,2005,1268,39,50,89
"16328",2034,1806,1503,86,96,182
"16329",2356,2030,1533,54,80,134
"16330",1733,1108,1573,68,53,121
"16331",2302,1841,1706,34,46,80
"16332",50,2136,1734,46,56,102
"16333",1918,1613,1740,34,33,67
"16334",1734,1629,33,44,49,93
"16335",2047,1921,1000,62,81,143
"16336",1826,1706,1008,136,156,292
"16337",212,2211,1054,56,66,122
"16338",2342,1956,1111,44,51,95
"16339",1433,1201,1118,49,36,85
"16340",1741,1401,1137,53,63,116
"16341",2350,2211,1142,38,66,104
"16342",39,2210,1169,34,55,89
"16343",1248,1023,1179,98,73,171
"16344",2256,1933,1192,32,33,65
"16345",2115,1918,1249,63,83,146
"16346",1539,1453,1261,34,43,77
"16347",1824,1456,1266,60,57,117
"16348",1607,1453,1418,53,43,96
"16349",1729,1603,1459,79,78,157
"16350",2008,1731,1503,60,61,121
"16351",1730,1305,1559,46,35,81
"16352",2258,1935,1586,43,35,78
"16353",2256,2007,1661,37,57,94
"16354",2034,1828,1707,44,33,77
"16355",2102,1921,1000,77,81,158
"16356",1118,732,1077,50,47,97
"16357",2234,2023,1091,59,83,142
"16358",1808,1403,1559,34,43,77
"16359",1220,1102,1724,97,122,219
"16360",1534,1152,1564,84,87,171
"16361",1111,1001,1677,43,56,99
"16362",2111,1627,1004,47,32,79
"16363",14,2149,1033,154,154,308
"16364",1902,1343,1087,84,48,132
"16365",2210,1935,1181,133,120,253
"16366",2203,1731,1202,89,101,190
"16367",2041,1926,1207,53,60,113
"16368",2132,2030,1241,69,80,149
"16369",1626,1402,1501,31,47,78
"16370",1652,1404,1561,37,54,91
"16371",2353,1854,1658,104,74,178
"16372",2120,1917,1659,36,46,82
"16373",49,2220,1712,90,73,163
"16374",1638,1229,106,81,104,185
"16375",2008,1826,1110,38,36,74
"16376",2202,1916,1121,107,101,208
"16377",2322,2144,1406,42,53,95
"16378",2234,1834,1429,96,44,140
"16379",1656,1538,1459,51,58,109
"16380",1819,1703,1481,58,68,126
"16381",2322,1958,1496,37,48,85
"16382",2023,1753,1503,75,83,158
"16383",2145,1753,1541,34,53,87
"16384",1804,1349,1559,80,79,159
"16385",1425,1019,1583,88,74,162
"16386",1942,1852,1603,49,57,106
"16387",1939,1712,1662,89,102,191
"16388",1443,1026,1690,80,91,171
"16389",32,2009,1732,48,64,112
"16390",2001,1848,59,31,54,85
"16391",1609,1145,106,54,60,114
"16392",2004,1626,1027,33,41,74
"16393",1505,1240,1118,76,70,146
"16394",213,2316,1150,149,156,305
"16395",2115,1901,1181,78,86,164
"16396",2053,1942,1207,36,47,83
"16397",1637,1404,1596,63,49,112
"16398",139,2257,1661,195,222,417
"16399",1946,1537,62,45,67,112
"16400",1135,814,1160,47,44,91
"16401",1547,1130,1196,34,50,84
"16402",1538,1446,1261,33,36,69
"16403",40,2053,1268,74,98,172
"16404",6,2002,1546,222,252,474
"16405",1722,1506,1651,33,36,69
"16406",2050,1815,1121,35,40,75
"16407",2028,1806,1181,31,31,62
"16408",1159,753,1281,31,38,69
"16409",1952,1747,1503,44,77,121
"16410",1944,1731,1662,94,121,215
"16411",1524,1052,1,74,77,151
"16412",1703,1604,35,43,38,81
"16413",1753,1607,1008,103,97,200
"16414",2212,1947,1033,32,32,64
"16415",2343,2209,1406,63,78,141
"16416",29,2214,1616,39,59,98
"16417",1727,1517,1651,38,47,85
"16418",2320,1917,1658,71,97,168
"16419",2317,2000,1704,37,45,82
"16420",2024,1637,1027,53,52,105
"16421",1751,1559,1036,111,89,200
"16422",1219,1034,1179,69,84,153
"16423",2143,1719,1202,69,89,158
"16424",2357,2246,1247,103,96,199
"16425",1742,1328,1559,58,58,116
"16426",1937,1618,1740,53,38,91
"16427",1828,1644,33,108,74,182
"16428",1916,1809,35,176,163,339
"16429",2048,1605,62,105,95,200
"16430",2120,1948,1000,95,108,203
"16431",2157,1702,1004,93,67,160
"16432",51,2224,1005,56,69,125
"16433",1835,1606,1008,145,96,241
"16434",2157,1824,1027,146,159,305
"16435",1813,1606,1028,108,86,194
"16436",2212,2010,1033,32,55,87
"16437",1735,1611,1036,95,101,196
"16438",2300,2157,1057,42,47,89
"16439",1746,1559,1083,117,79,196
"16440",2011,1332,1087,153,37,190
"16441",2113,1719,1089,121,84,205
"16442",2151,1908,1121,96,93,189
"16443",2115,1733,1159,73,71,144
"16444",2158,1758,1171,118,113,231
"16445",2106,1834,1181,49,39,88
"16446",1920,1710,1187,119,75,194
"16447",2318,2004,1192,44,54,98
"16448",2201,1627,1202,87,37,124
"16449",2132,2022,1207,104,116,220
"16450",2050,2000,1233,36,45,81
"16451",2244,2120,1243,113,120,233
"16452",12,2311,1247,118,121,239
"16453",1758,1612,1261,173,122,295
"16454",2049,1625,1276,234,190,424
"16455",1752,1558,1277,94,73,167
"16456",2019,1846,1285,164,176,340
"16457",1944,1547,1439,92,77,169
"16458",8,2318,1445,94,118,212
"16459",1809,1610,1459,124,90,214
"16460",1906,1724,1488,66,34,100
"16461",2132,1910,1503,144,160,304
"16462",1835,1604,1511,88,94,182
"16463",2012,1559,1519,152,169,321
"16464",1756,1552,1542,91,82,173
"16465",2219,1729,1546,109,95,204
"16466",2302,1959,1588,32,39,71
"16467",2125,2039,1603,152,164,316
"16468",2141,1922,1609,83,82,165
"16469",14,2209,1615,38,54,92
"16470",1940,1550,1623,63,65,128
"16471",1824,1707,1638,48,67,115
"16472",1741,1617,1639,103,83,186
"16473",1755,1552,1651,66,82,148
"16474",2256,2052,1659,132,141,273
"16475",2302,1958,1661,43,48,91
"16476",1849,1604,1662,39,34,73
"16477",1757,1615,1667,128,100,228
"16478",2144,1634,1676,91,39,130
"16479",39,2308,1698,115,103,218
"16480",2108,1923,1707,78,88,166
"16481",2354,2202,1712,35,55,90
"16482",2012,1632,1740,88,52,140
"16483",2054,1616,62,111,106,217
"16484",1639,1526,1036,44,61,105
"16485",1537,1246,1043,88,81,169
"16486",1410,958,1165,115,148,263
"16487",2036,1915,1207,59,60,119
"16488",2119,2023,1241,56,73,129
"16489",2221,1805,1546,115,135,250
"16490",2252,1935,1586,37,35,72
"16491",2,2104,1588,92,104,196
"16492",2302,2017,1661,43,67,110
"16493",2344,1924,1706,76,89,165
"16494",1303,1043,1714,108,103,211
"16495",2006,1849,59,36,55,91
"16496",2106,1936,1019,38,36,74
"16497",1819,1712,1031,90,97,187
"16498",1423,1047,1085,33,37,70
"16499",2131,1826,1429,33,36,69
"16500",11,2058,1523,49,58,107
"16501",1438,1052,1552,46,42,88
"16502",12,2219,1712,53,72,125
"16503",1500,1224,1718,37,39,76
"16504",1808,1416,1068,80,81,161
"16505",1919,1822,1145,31,37,68
"16506",1904,1521,1178,280,286,566
"16507",1546,1440,1418,78,75,153
"16508",1702,1512,1542,37,42,79
"16509",2124,1838,1553,37,38,75
"16510",2149,2026,1689,146,156,302
"16511",928,800,1697,48,45,93
"16512",1404,1215,1023,47,35,82
"16513",2227,1950,1033,47,35,82
"16514",1655,1519,1036,60,54,114
"16515",1553,1410,1097,60,65,125
"16516",2230,1845,1171,150,160,310
"16517",1605,1119,1196,58,39,97
"16518",1411,1230,1273,36,40,76
"16519",1727,1556,1277,69,71,140
"16520",1608,1126,1401,43,41,84
"16521",16,2058,1432,103,103,206
"16522",1654,1213,1574,56,38,94
"16523",2331,2022,1586,76,82,158
"16524",1139,1030,1595,95,95,190
"16525",1655,1435,1596,81,80,161
"16526",1811,1633,1638,35,33,68
"16527",2305,1823,1658,56,43,99
"16528",2011,1527,1699,144,122,266
"16529",14,2204,1712,55,57,112
"16530",1122,930,52,121,115,236
"16531",2110,1716,1004,46,81,127
"16532",1902,1723,1028,157,163,320
"16533",1649,1514,1036,54,49,103
"16534",1949,1515,1087,131,140,271
"16535",1632,1207,1127,260,267,527
"16536",2252,1958,1150,43,53,96
"16537",1802,1401,1196,175,201,376
"16538",1502,1400,1197,37,45,82
"16539",2211,1743,1202,97,113,210
"16540",1534,1344,1231,124,129,253
"16541",2045,1845,1249,33,50,83
"16542",1741,1326,1258,241,251,492
"16543",1549,1443,1261,44,33,77
"16544",1210,821,1281,42,66,108
"16545",1638,1517,1459,33,37,70
"16546",1842,1432,1574,164,177,341
"16547",2352,2053,1588,82,93,175
"16548",1453,1133,1594,50,58,108
"16549",1952,1539,1699,125,134,259
"16550",2314,1855,1706,46,60,106
"16551",2105,1640,1004,41,45,86
"16552",1704,1538,1036,64,68,132
"16553",18,2043,1111,80,98,178
"16554",2103,1816,1121,48,41,89
"16555",1719,1412,1151,33,42,75
"16556",1634,1231,1196,87,111,198
"16557",1413,1123,1198,114,113,227
"16558",1450,1012,1258,70,57,127
"16559",1548,1453,1261,43,43,86
"16560",1944,1558,1439,92,88,180
"16561",1855,1749,1488,55,59,114
"16562",1742,1307,1574,104,92,196
"16563",1954,1650,1606,33,55,88
"16564",39,2213,1615,63,58,121
"16565",1902,1434,1699,75,69,144
"16566",2025,1653,1089,73,58,131
"16567",1526,1342,1097,33,37,70
"16568",1426,1216,1118,37,46,83
"16569",1806,1648,1187,45,53,98
"16570",2040,1857,1207,52,31,83
"16571",1958,1722,1503,50,52,102
"16572",1803,1532,1511,56,62,118
"16573",1808,1649,1638,32,49,81
"16574",1835,1617,1651,106,107,213
"16575",1115,947,1679,59,37,96
"16576",2313,1958,1704,33,43,76
"16577",1137,838,1160,49,68,117
"16578",1415,1308,1568,66,83,149
"16579",1103,911,1571,45,38,83
"16580",2015,1852,1689,52,62,114
"16581",941,825,1697,61,70,131
"16582",1444,1042,1,34,67,101
"16583",2132,1954,47,36,44,80
"16584",2318,1940,1074,39,40,79
"16585",1137,840,1160,49,70,119
"16586",1856,1747,1187,95,112,207
"16587",1623,1147,1401,58,62,120
"16588",2348,2022,1533,46,72,118
"16589",2106,1641,1546,40,51,91
"16590",1745,1555,1666,54,75,129
"16591",913,811,1697,33,56,89
"16592",1200,1035,1201,65,65,130
"16593",1237,852,1208,47,62,109
"16594",1129,819,1211,36,34,70
"16595",1548,1154,1444,33,34,67
"16596",1200,741,89,100,101,201
"16597",1331,904,1025,80,84,164
"16598",1943,1652,1492,49,62,111
"16599",1225,1004,1585,60,74,134
"16600",2223,2105,1602,87,79,166
"16601",2128,2034,1709,156,164,320
"16602",1747,1640,6,53,45,98
"16603",1809,1645,1015,39,45,84
"16604",1935,1656,1226,86,86,172
"16605",1635,1352,1479,42,37,79
"16606",2354,1939,1498,43,49,92
"16607",2010,1727,1503,60,52,112
"16608",939,758,1447,40,33,73
"16609",2204,1935,1091,41,45,86
"16610",2101,1655,1546,34,65,99
"16611",1,2316,1687,111,126,237
"16612",1941,1646,1846,34,42,76
"16613",1927,1638,8,46,62,108
"16614",1804,1510,2084,89,99,188
"16615",1952,1627,8,71,51,122
"16616",2015,1640,8,94,64,158
"16617",2208,1821,54,94,51,145
"16618",2241,2123,239,56,88,144
"16619",2333,1912,1160,98,97,195
"16620",2104,1848,693,74,88,162
"16621",1405,1149,517,35,49,84
"16622",1416,1304,581,31,39,70
"16623",2115,2008,285,50,58,108
"16624",2029,1944,915,134,139,273
"16625",2124,2045,1576,54,60,114
"16626",2100,1909,41,70,64,134
"16627",2101,2007,47,36,37,73
"16628",2113,2021,48,128,141,269
"16629",2027,1932,50,57,62,119
"16630",1906,1811,261,41,46,87
"16631",2246,1831,112,51,56,107
"16632",2320,2006,45,35,56,91
"16633",1906,1807,1366,36,37,73
"16634",2115,1945,43,70,70,140
"16635",2159,2025,2623,34,50,84
"16636",2010,1800,902,45,55,100
"16637",1919,1804,513,39,44,83
"16638",2246,1943,1191,86,93,179
"16639",2138,2027,285,73,77,150
"16640",2242,2121,1288,32,41,73
"16641",2027,1850,41,37,45,82
"16642",2336,2027,45,51,77,128
"16643",2117,2009,218,32,34,66
"16644",2021,1914,1366,111,104,215
"16645",2302,2206,1034,82,86,168
"16646",2114,2023,207,34,43,77
"16647",25,2138,1674,55,58,113
"16648",2008,1924,915,113,119,232
"16649",2247,2123,1288,37,43,80
"16650",2026,1840,41,36,35,71
"16651",1452,1400,28,57,60,117
"16652",1903,1810,261,38,45,83
"16653",1951,1854,1366,81,84,165
"16654",1127,829,838,37,49,86
"16655",2225,2131,1034,45,51,96
"16656",1420,1213,1167,50,63,113
"16657",1931,1847,628,71,82,153
"16658",20,2135,1674,50,55,105
"16659",2259,1919,757,34,59,93
"16660",1008,921,1,53,56,109
"16661",1243,1148,20,48,48,96
"16662",1635,1542,36,35,42,77
"16663",2252,1837,112,57,62,119
"16664",1845,1713,3575,35,38,73
"16665",1345,930,894,35,40,75
"16666",1634,1445,1442,64,70,134
"16667",1606,1519,3890,46,49,95
"16668",1611,1511,2387,41,41,82
"16669",2204,2117,2189,99,107,206
"16670",2254,2127,2623,89,112,201
"16671",1757,1400,3085,67,80,147
"16672",1034,944,1231,39,44,83
"16673",2200,1913,1191,40,63,103
"16674",1645,1510,153,130,140,270
"16675",1552,1506,27,37,41,78
"16676",1811,1717,35,51,47,98
"16677",1629,1521,34,59,51,110
"16678",1803,1655,36,123,115,238
"16679",1857,1748,40,117,108,225
"16680",1838,1742,42,68,72,140
"16681",1643,1523,495,58,68,126
"16682",1831,1652,31,91,82,173
"16683",1625,1522,2844,55,52,107
"16684",2246,1824,112,51,49,100
"16685",1559,1502,23,94,97,191
"16686",1815,1700,988,160,155,315
"16687",1822,1702,1009,97,102,199
"16688",1938,1819,1464,38,44,82
"16689",2123,1908,37,103,118,221
"16690",1825,1710,1300,45,35,80
"16691",840,751,2534,45,56,101
"16692",2021,1842,39,46,62,108
"16693",1838,1712,33,63,67,130
"16694",1714,1627,405,49,57,106
"16695",1905,1704,1050,70,69,139
"16696",1733,1639,40,33,39,72
"16697",2138,2045,56,43,45,88
"16698",1621,1454,495,36,39,75
"16699",1902,1810,261,37,45,82
"16700",1145,1004,277,80,84,164
"16701",1437,1340,683,37,40,77
"16702",1723,1620,1224,53,50,103
"16703",927,830,1628,32,35,67
"16704",1917,1518,3085,147,158,305
"16705",2224,1934,1191,64,84,148
"16706",1815,1717,36,135,137,272
"16707",2111,2009,44,191,189,380
"16708",2114,2007,48,129,127,256
"16709",2328,1912,112,93,97,190
"16710",2027,1801,37,47,51,98
"16711",2116,2020,586,61,80,141
"16712",1737,1638,1224,67,68,135
"16713",1925,1809,513,45,49,94
"16714",1617,1434,1098,67,79,146
"16715",1153,1105,16,53,65,118
"16716",1427,1336,28,32,36,68
"16717",1903,1809,46,33,39,72
"16718",17,2018,112,142,163,305
"16719",2301,2010,1191,101,120,221
"16720",1328,1243,2268,63,68,131
"16721",1606,1514,445,66,74,140
"16722",1741,1647,2677,41,47,88
"16723",1814,1509,1673,34,39,73
"16724",2321,2024,2081,36,44,80
"16725",1713,1316,1989,33,46,79
"16726",1408,1222,3576,163,172,335
"16727",2036,1855,1421,36,40,76
"16728",1821,1730,3216,51,60,111
"16729",1531,1436,599,61,66,127
"16730",1907,1806,1720,37,36,73
"16731",1618,1516,1359,33,41,74
"16732",2050,1929,3146,40,49,89
"16733",1621,1434,229,36,39,75
"16734",2118,2020,586,63,80,143
"16735",2331,2212,1288,76,87,163
"16736",1016,910,8,76,70,146
"16737",1154,1033,406,44,48,92
"16738",1546,1428,873,111,118,229
"16739",1215,1017,523,60,52,112
"16740",207,2302,51,137,137,274
"16741",2044,1947,586,44,47,91
"16742",1434,1323,769,34,38,72
"16743",1138,1036,823,53,36,89
"16744",1310,1225,1286,40,40,80
"16745",2201,2025,1721,36,45,81
"16746",2304,1923,469,49,63,112
"16747",2244,2159,51,84,89,173
"16748",1047,949,12,47,49,96
"16749",1133,1038,16,33,38,71
"16750",1725,1633,38,60,63,123
"16751",2018,1928,46,108,118,226
"16752",1241,1105,3,121,115,236
"16753",1352,929,1025,37,34,71
"16754",2318,1900,3168,83,85,168
"16755",1141,1031,5,66,56,122
"16756",1511,1410,23,46,45,91
"16757",2228,2132,468,43,47,90
"16758",1925,1806,198,260,271,531
"16759",1156,1023,1107,46,38,84
"16760",1139,837,1628,39,47,86
"16761",35,2229,989,50,69,119
"16762",2246,2151,218,61,66,127
"16763",2002,1842,861,57,57,114
"16764",1143,1025,942,38,40,78
"16765",31,2049,45,71,99,170
"16766",1451,1044,403,81,84,165
"16767",1026,844,473,31,44,75
"16768",1613,1427,1396,38,47,85
"16769",1234,942,1,64,72,136
"16770",1412,1122,2279,77,87,164
"16771",1933,1808,39,38,33,71
"16772",6,2303,841,121,123,244
"16773",2354,2229,1053,34,59,93
"16774",2354,2258,218,129,133,262
"16775",1605,1516,3600,40,46,86
"16776",836,647,280,41,47,88
"16777",1558,1505,383,43,40,83
"16778",2000,1911,2690,40,41,81
"16779",2122,1957,3977,142,147,289
"16780",1542,1441,25,42,41,83
"16781",1455,1337,717,55,47,102
"16782",1623,1329,3585,38,39,77
"16783",2013,1739,1522,53,49,102
"16784",1053,954,38,103,104,207
"16785",1455,1356,1795,40,41,81
"16786",1223,1007,1487,33,37,70
"16787",1707,1612,3552,37,37,74
"16788",2323,2201,51,78,86,164
"16789",7,1944,3873,132,129,261
"16790",45,2347,820,100,102,202
"16791",951,853,2052,51,53,104
"16792",1333,900,201,78,55,133
"16793",49,2053,2884,64,73,137
"16794",2056,1925,175,36,60,96
"16795",1804,1641,366,34,36,70
"16796",2320,2202,908,35,37,72
"16797",1854,1809,2989,44,49,93
"16798",2212,2023,37,197,193,390
"16799",2201,2120,51,41,50,91
"16800",1509,1415,30,44,45,89
"16801",1732,1633,40,32,33,65
"16802",748,646,1636,33,31,64
"16803",1147,1100,175,82,95,177
"16804",1714,1358,3251,44,33,77
"16805",1809,1636,150,34,51,85
"16806",1701,1549,1149,31,44,75
"16807",2146,2051,110,36,46,82
"16808",131,2328,484,86,103,189
"16809",1447,1325,118,72,70,142
"16810",1735,1611,955,35,31,66
"16811",1836,1750,1362,46,55,101
"16812",2252,2202,60,57,62,119
"16813",2249,2125,239,64,90,154
"16814",107,2100,112,192,205,397
"16815",1536,1430,787,86,95,181
"16816",1735,1315,3085,45,35,80
"16817",1834,1630,1050,39,35,74
"16818",2113,1720,4090,270,250,520
"16819",1756,1602,4094,125,87,212
"16820",1005,820,4107,82,60,142
"16821",1923,1636,4107,35,41,76
"16822",55,1,4116,144,151,295
"16823",2332,2146,4121,108,121,229
"16824",2244,2056,4121,60,71,131
"16825",1833,1513,4125,58,38,96
"16826",2015,1551,4125,160,76,236
"16827",1825,1526,4125,50,51,101
"16828",1739,1510,4132,54,35,89
"16829",1817,1647,4143,36,39,75
"16830",1812,1638,4143,32,33,65
"16831",1850,1709,4143,37,31,68
"16832",1854,1633,4144,252,203,455
"16833",1545,1424,4144,63,74,137
"16834",1920,1758,4147,55,73,128
"16835",1932,1602,4151,128,107,235
"16836",1820,1504,4151,56,49,105
"16837",1825,1508,4151,61,53,114
"16838",1820,1706,4153,37,43,80
"16839",1642,1434,4158,85,88,173
"16840",1304,903,4163,130,103,233
"16841",1202,930,4164,192,130,322
"16842",1034,931,4165,33,31,64
"16843",1107,949,4165,66,49,115
"16844",1851,1722,4165,41,37,78
"16845",1840,1704,4165,75,64,139
"16846",1842,1720,4165,77,80,157
"16847",1941,1818,4165,136,138,274
"16848",1919,1759,4165,67,72,139
"16849",1949,1620,4179,142,140,282
"16850",2054,1704,4179,207,184,391
"16851",1805,1435,4179,38,35,73
"16852",1242,1123,4180,70,73,143
"16853",1111,917,4183,93,97,190
"16854",1326,1209,4188,191,204,395
"16855",1137,935,4188,82,50,132
"16856",1541,1346,4190,261,261,522
"16857",1252,1105,4190,90,100,190
"16858",1454,1345,4191,46,53,99
"16859",1540,1425,4191,90,93,183
"16860",1455,1338,4191,45,46,91
"16861",1914,1743,4196,79,78,157
"16862",2035,1910,4196,160,165,325
"16863",1831,1700,4196,36,35,71
"16864",1834,1500,4201,71,67,138
"16865",1802,1438,4201,39,45,84
"16866",1531,1225,4202,49,45,94
"16867",1701,1403,4204,31,33,64
"16868",1415,1116,4220,35,36,71
"16869",1852,1711,4221,173,161,334
"16870",1853,1705,4221,160,139,299
"16871",1930,1805,4222,86,80,166
"16872",1931,1811,4222,87,86,173
"16873",1951,1830,4222,107,105,212
"16874",1905,1750,4222,61,65,126
"16875",1855,1743,4223,41,48,89
"16876",1734,1431,4223,46,56,102
"16877",932,822,4226,48,62,110
"16878",929,804,4226,36,34,70
"16879",1346,1223,4238,48,53,101
"16880",1900,1614,4239,199,189,388
"16881",1700,1435,4239,79,90,169
"16882",1716,1408,4241,47,48,95
"16883",2053,1723,4241,264,243,507
"16884",2203,1918,4250,222,213,435
"16885",1136,808,4253,32,33,65
"16886",1216,847,4253,70,72,142
"16887",2102,1744,4261,37,39,76
"16888",1820,1602,4263,39,32,71
"16889",1854,1637,4263,73,67,140
"16890",2149,2021,4265,36,36,72
"16891",2211,2038,4265,58,53,111
"16892",2208,2048,4265,55,63,118
"16893",2207,2048,4265,54,63,117
"16894",2152,2026,4265,39,41,80
"16895",2151,2028,4265,38,43,81
"16896",2238,2119,4265,85,94,179
"16897",2235,2103,4265,49,43,92
"16898",2324,2132,4265,131,107,238
"16899",2334,2054,4268,119,89,208
"16900",2327,2107,4269,72,62,134
"16901",1648,1350,4279,180,195,375
"16902",1444,1114,4279,54,39,93
"16903",1924,1622,4283,42,52,94
"16904",1931,1618,4283,47,48,95
"16905",1932,1618,4283,48,48,96
"16906",2137,1818,4283,173,168,341
"16907",1454,1349,4289,32,44,76
"16908",1308,1131,4292,165,161,326
"16909",1232,1104,4292,129,134,263
"16910",1709,1556,4293,45,41,86
"16911",1706,1558,4293,40,43,83
"16912",1906,1714,4293,160,119,279
"16913",1711,1557,4293,45,42,87
"16914",2057,1905,4299,65,70,135
"16915",2042,1857,4299,50,62,112
"16916",2145,1946,4299,113,111,224
"16917",2155,2006,4299,123,131,254
"16918",1623,1355,4299,44,50,94
"16919",1234,1153,4302,64,48,112
"16920",125,6,4306,87,71,158
"16921",2054,2003,4307,40,43,83
"16922",2154,2107,4307,102,107,209
"16923",2132,2042,4307,78,82,160
"16924",1141,1033,4314,171,188,359
"16925",1458,1326,4315,34,36,70
"16926",1829,1521,4319,50,46,96
"16927",1920,1600,4319,101,85,186
"16928",1918,1549,4319,99,74,173
"16929",1804,1506,4319,39,46,85
"16930",1753,1608,4321,117,113,230
"16931",1742,1601,4321,106,106,212
"16932",1518,1223,4325,67,88,155
"16933",1045,950,4326,119,140,259
"16934",2002,1720,4331,153,95,248
"16935",1846,1709,4331,77,84,161
"16936",1920,1740,4331,111,115,226
"16937",1827,1441,4332,71,71,142
"16938",1759,1416,4332,45,46,91
"16939",2154,2044,4334,104,104,208
"16940",1057,950,4338,44,35,79
"16941",1513,1333,4341,41,38,79
"16942",2319,2213,4342,38,43,81
"16943",945,801,4343,39,31,70
"16944",1951,1859,4343,75,79,154
"16945",1942,1856,4343,66,76,142
"16946",47,2140,4345,100,109,209
"16947",31,2119,4345,86,88,174
"16948",2336,2032,4349,38,57,95
"16949",3,2038,4349,65,63,128
"16950",109,2130,4349,131,115,246
"16951",3,2051,4349,65,76,141
"16952",103,2153,4349,125,138,263
"16953",2345,2039,4349,47,64,111
"16954",2313,2207,4358,34,42,76
"16955",2310,2202,4358,31,37,68
"16956",2320,2206,4359,33,46,79
"16957",53,2325,4359,126,125,251
"16958",2329,2201,4359,42,41,83
"16959",2027,1851,4361,33,41,74
"16960",2036,1850,4361,42,40,82
"16961",2054,1915,4361,60,65,125
"16962",2100,1922,4370,64,62,126
"16963",2314,2026,4386,58,71,129
"16964",1350,1254,4392,49,47,96
"16965",2059,2001,4398,35,36,71
"16966",2145,2047,4398,83,82,165
"16967",1150,938,4400,43,40,83
"16968",2121,2033,4403,69,73,142
"16969",2200,2114,4403,108,114,222
"16970",1210,1046,4404,41,36,77
"16971",2319,2201,4410,235,231,466
"16972",2121,2015,4410,117,125,242
"16973",2051,1939,4410,66,66,132
"16974",1644,1519,4412,55,64,119
"16975",1859,1629,4412,190,134,324
"16976",1734,1601,4412,107,106,213
"16977",1224,1057,4419,49,47,96
"16978",1231,924,4420,64,59,123
"16979",1220,922,4420,53,57,110
"16980",13,2234,4421,138,144,282
"16981",2328,2156,4421,93,106,199
"16982",2338,2200,4421,103,110,213
"16983",2019,1716,4422,61,56,117
"16984",948,822,4426,56,62,118
"16985",1810,1717,4427,91,92,183
"16986",1853,1743,4427,134,118,252
"16987",2310,2219,4427,393,394,787
"16988",1505,1125,4434,53,58,111
"16989",2007,1659,4436,40,34,74
"16990",2209,1920,4436,160,175,335
"16991",2035,1713,4436,66,48,114
"16992",2058,1747,4436,89,82,171
"16993",1202,1051,4438,96,96,192
"16994",1439,1238,4443,49,43,92
"16995",39,2313,4449,167,173,340
"16996",2331,2149,4449,99,89,188
"16997",2224,2051,4449,34,31,65
"16998",1809,1642,4451,41,42,83
"16999",1809,1646,4451,41,46,87
"17000",1848,1658,4451,80,58,138
"17001",2014,1857,4452,134,132,266
"17002",1907,1738,4452,67,53,120
"17003",1142,1028,4453,144,133,277
"17004",1104,1011,4454,108,116,224
"17005",1225,848,4455,86,43,129
"17006",2354,2058,4456,58,63,121
"17007",2348,2054,4456,52,59,111
"17008",155,2301,4456,179,186,365
"17009",2345,2054,4456,49,59,108
"17010",1757,1448,4457,41,33,74
"17011",2132,1832,4458,120,122,242
"17012",2137,1822,4458,123,112,235
"17013",2035,1730,4458,63,60,123
"17014",1936,1714,4459,128,99,227
"17015",1821,1639,4459,57,69,126
"17016",1938,1723,4464,165,163,328
"17017",1819,1609,4464,86,89,175
"17018",2132,2041,4466,60,71,131
"17019",2200,2055,4466,88,85,173
"17020",2115,2023,4466,43,53,96
"17021",2147,2050,4466,75,80,155
"17022",1730,1606,4472,75,61,136
"17023",1653,1548,4472,38,43,81
"17024",2011,1845,4472,236,220,456
"17025",1738,1614,4472,83,69,152
"17026",1734,1610,4472,81,65,146
"17027",1706,1550,4472,51,45,96
"17028",1802,1652,4472,107,107,214
"17029",2129,1811,4473,57,63,120
"17030",2336,2019,4473,202,209,411
"17031",2112,1742,4473,58,52,110
"17032",23,2253,4478,78,88,166
"17033",2146,1845,4481,65,75,140
"17034",1750,1612,4482,32,37,69
"17035",1845,1655,4482,85,80,165
"17036",1847,1635,4482,87,60,147
"17037",1850,1533,4484,60,63,123
"17038",1831,1503,4484,41,33,74
"17039",1924,1603,4484,94,93,187
"17040",1835,1513,4484,45,43,88
"17041",1439,1309,4485,165,134,299
"17042",1929,1724,4494,95,89,184
"17043",1914,1712,4494,80,77,157
"17044",2136,2041,4498,72,76,148
"17045",2341,2250,4498,197,205,402
"17046",1350,1256,4498,42,61,103
"17047",1245,1020,4507,145,160,305
"17048",250,2314,4509,246,254,500
"17049",2109,1625,4511,267,175,442
"17050",1735,1422,4511,53,52,105
"17051",2329,2009,4512,45,39,84
"17052",2345,2034,4512,61,64,125
"17053",1722,1554,4519,89,89,178
"17054",1754,1623,4519,121,118,239
"17055",2335,2039,4525,62,74,136
"17056",1424,1128,4528,63,73,136
"17057",2302,2207,4536,39,37,76
"17058",2,2305,4536,99,95,194
"17059",2050,1714,4547,37,39,76
"17060",2125,1740,4547,62,55,117
"17061",2135,1758,4547,82,83,165
"17062",2257,2201,4551,59,56,115
"17063",2308,2224,4551,70,79,149
"17064",2236,2140,4551,38,35,73
"17065",2331,2239,4551,93,94,187
"17066",1731,1624,4552,92,94,186
"17067",1656,1530,4552,57,40,97
"17068",1630,1524,4552,31,34,65
"17069",1659,1546,4552,60,56,116
"17070",1659,1554,4552,62,64,126
"17071",2231,2111,4554,89,101,190
"17072",2220,2048,4554,78,78,156
"17073",2305,2151,4554,123,141,264
"17074",2118,2021,4555,43,56,99
"17075",2257,2126,4555,142,121,263
"17076",2230,2124,4555,117,119,236
"17077",1125,953,4557,61,33,94
"17078",1344,1223,4558,67,43,110
"17079",1751,1616,4559,152,116,268
"17080",1948,1822,4560,194,167,361
"17081",2036,1934,4561,117,114,231
"17082",1906,1554,4563,88,99,187
"17083",1842,1518,4563,64,63,127
"17084",2050,1716,4563,192,181,373
"17085",1842,1525,4563,64,70,134
"17086",1717,1431,4566,96,96,192
"17087",2020,1628,4566,279,213,492
"17088",1833,1708,4571,36,31,67
"17089",2137,2022,4571,235,242,477
"17090",1901,1718,4571,79,58,137
"17091",1855,1738,4571,73,78,151
"17092",2021,1911,4573,58,56,114
"17093",2126,2000,4573,125,105,230
"17094",1639,1451,4575,76,31,107
"17095",1856,1748,4575,213,208,421
"17096",1932,1811,4576,174,156,330
"17097",2127,2020,4587,43,55,98
"17098",2138,2034,4587,54,69,123
"17099",2230,2130,4587,106,125,231
"17100",2205,2113,4589,121,133,254
"17101",2356,2108,4601,39,58,97
"17102",9,2050,4601,52,40,92
"17103",17,2117,4601,50,57,107
"17104",2358,2057,4601,41,47,88
"17105",121,2220,4601,124,130,254
"17106",3,2103,4601,48,53,101
"17107",2354,2056,4601,37,46,83
"17108",5,2111,4601,48,61,109
"17109",25,2131,4601,68,81,149
"17110",1,2052,4601,44,42,86
"17111",49,2155,4601,82,95,177
"17112",1312,915,4602,119,115,234
"17113",1457,1402,4606,57,62,119
"17114",1124,1031,4607,97,101,198
"17115",1705,1405,4607,32,35,67
"17116",2020,1833,4609,92,43,135
"17117",2036,1936,4609,108,106,214
"17118",1814,1601,4619,103,70,173
"17119",1736,1553,4619,65,62,127
"17120",1810,1651,4626,56,51,107
"17121",1947,1814,4626,153,134,287
"17122",1947,1837,4626,153,157,310
"17123",1815,1659,4626,61,59,120
"17124",1807,1706,4631,88,81,169
"17125",1820,1658,4631,99,73,172
"17126",105,2336,4635,193,185,378
"17127",2357,2236,4635,125,125,250
"17128",2139,2013,4637,34,38,72
"17129",2153,2028,4637,48,53,101
"17130",2319,2151,4637,134,136,270
"17131",2202,2019,4637,57,44,101
"17132",2208,2037,4637,63,62,125
"17133",1118,941,4639,48,53,101
"17134",1130,956,4639,60,68,128
"17135",1101,919,4639,31,31,62
"17136",1823,1645,4641,143,147,290
"17137",1800,1618,4641,120,120,240
"17138",2049,1901,4642,46,41,87
"17139",2144,2009,4642,101,109,210
"17140",2212,2049,4648,85,79,164
"17141",2316,2133,4648,114,83,197
"17142",2308,2152,4648,106,102,208
"17143",2358,2245,4648,156,155,311
"17144",1959,1621,4649,179,146,325
"17145",1747,1427,4649,47,32,79
"17146",1026,845,4654,81,75,156
"17147",1000,812,4654,55,42,97
"17148",1759,1618,4654,114,108,222
"17149",1112,922,4654,127,112,239
"17150",1016,841,4654,71,71,142
"17151",1558,1425,4656,81,85,166
"17152",1609,1428,4656,94,88,182
"17153",1827,1648,4657,49,48,97
"17154",2010,1825,4657,152,145,297
"17155",1829,1648,4657,41,38,79
"17156",2311,2133,4658,193,193,386
"17157",2124,1954,4658,86,94,180
"17158",2029,1903,4658,31,43,74
"17159",2239,1951,4658,37,36,73
"17160",2235,2108,4659,76,88,164
"17161",2237,2103,4659,78,83,161
"17162",1017,834,4663,59,69,128
"17163",1122,939,4663,124,134,258
"17164",1130,926,4663,132,121,253
"17165",1529,1120,4665,81,43,124
"17166",1552,1404,4671,94,94,188
"17167",1549,1413,4671,46,58,104
"17168",2028,1834,4673,68,64,132
"17169",2006,1819,4673,43,44,87
"17170",2023,1839,4673,58,64,122
"17171",2024,1823,4673,59,48,107
"17172",2029,1833,4673,64,58,122
"17173",2400,2218,4674,111,118,229
"17174",2333,2156,4674,84,96,180
"17175",2315,2135,4674,66,75,141
"17176",2320,2127,4674,71,67,138
"17177",2320,2123,4674,71,63,134
"17178",21,2252,4676,99,82,181
"17179",1652,1527,4678,134,137,271
"17180",1843,1614,4678,245,184,429
"17181",1520,1355,4678,42,45,87
"17182",1536,1408,4678,58,58,116
"17183",1111,955,4680,41,35,76
"17184",1232,1125,4680,120,125,245
"17185",1356,1303,4683,41,48,89
"17186",1604,1454,4683,49,39,88
"17187",1445,1322,4683,105,82,187
"17188",1750,1627,4684,154,132,286
"17189",1934,1608,4694,104,88,192
"17190",2009,1613,4694,139,93,232
"17191",1606,1255,4703,107,113,220
"17192",1450,1147,4703,31,45,76
"17193",1832,1454,4704,75,54,129
"17194",2034,1630,4704,197,150,347
"17195",1754,1435,4704,37,35,72
"17196",1740,1531,4706,50,51,101
"17197",1823,1559,4706,83,69,152
"17198",1846,1601,4706,116,81,197
"17199",1836,1612,4706,82,68,150
"17200",1815,1543,4706,85,63,148
"17201",1153,757,4708,48,42,90
"17202",2114,1809,54,40,39,79
"17203",1309,1014,1590,32,39,71
"17204",1210,918,1884,185,198,383
"17205",1809,1510,2084,94,99,193
"17206",1834,1448,4927,121,123,244
"17207",2000,1441,4927,207,116,323
"17208",1730,1414,4927,57,89,146
"17209",2114,1736,4928,144,151,295
"17210",2053,1658,4928,123,113,236
"17211",1742,1611,4956,239,246,485
"17212",1500,1325,4956,77,80,157
"17213",1530,1416,4956,107,131,238
"17214",1754,1629,4956,251,264,515
"17215",1928,1748,5181,80,78,158
"17216",2123,1958,5181,195,208,403
"17217",2147,1808,5408,63,71,134
"17218",2218,2050,1147,109,111,220
"17219",2226,1925,292,126,120,246
"17220",213,2312,292,353,347,700
"17221",2139,1838,292,79,73,152
"17222",1749,1624,1595,54,63,117
"17223",1556,1301,286,72,67,139
"17224",2121,1823,292,61,58,119
"17225",2157,1910,292,97,105,202
"17226",1417,1132,298,55,61,116
"17227",2315,1921,296,100,37,137
"17228",1517,1400,1597,57,74,131
"17229",1526,1233,286,42,39,81
"17230",1226,1103,2958,46,33,79
"17231",1229,1118,2958,64,63,127
"17232",1214,1054,3210,149,139,288
"17233",1036,918,3210,51,43,94
"17234",1420,1258,3216,80,68,148
"17235",1455,1349,3216,100,104,204
"17236",1359,1253,3216,44,48,92
"17237",2126,2017,3328,46,42,88
"17238",2128,2010,3328,48,35,83
"17239",2130,2023,3328,50,48,98
"17240",1704,1540,3390,59,45,104
"17241",1804,1645,3390,119,110,229
"17242",1724,1615,3390,34,35,69
"17243",2216,1950,3717,76,85,161
"17244",2139,1930,3717,39,65,104
"17245",2150,1928,3717,50,63,113
"17246",2214,1957,3717,54,67,121
"17247",1451,1337,3719,51,72,123
"17248",1450,1315,3719,50,50,100
"17249",1517,1400,3719,77,95,172
"17250",2321,2140,3724,81,70,151
"17251",2325,2128,3724,85,58,143
"17252",2241,2111,3724,56,66,122
"17253",1146,1019,3762,131,134,265
"17254",1819,1645,3762,524,520,1044
"17255",1034,909,3762,54,69,123
"17256",2002,1646,3786,92,56,148
"17257",1923,1657,3786,53,67,120
"17258",948,721,3786,918,931,1849
"17259",1902,1621,3786,32,31,63
"17260",1935,1715,3786,55,75,130
"17261",1931,1657,3786,51,57,108
"17262",2008,1729,3786,88,89,177
"17263",1458,1235,3796,73,80,153
"17264",1555,1331,3796,90,101,191
"17265",1013,749,3859,53,64,117
"17266",1026,749,3859,46,39,85
"17267",1846,1631,4497,131,131,262
"17268",1750,1519,5196,76,45,121
"17269",1802,1558,5196,88,84,172
"17270",1927,1649,5192,48,64,112
"17271",1911,1753,5254,89,93,182
"17272",2334,2122,5257,84,82,166
"17273",36,2239,5257,146,159,305
"17274",2247,2049,5257,37,49,86
"17275",1818,1629,5249,202,209,411
"17276",1649,1442,5249,113,102,215
"17277",1859,1657,5249,243,237,480
"17278",1636,1413,5202,73,63,136
"17279",1650,1448,5202,87,98,185
"17280",1606,1401,5202,43,51,94
"17281",2242,2010,5204,40,55,95
"17282",1830,1622,5204,51,52,103
"17283",1018,949,5189,33,39,72
"17284",2358,2046,5190,45,71,116
"17285",322,3,5190,249,268,517
"17286",2146,1957,4455,44,72,116
"17287",1149,800,5227,88,45,133
"17288",1356,1055,5227,215,220,435
"17289",1100,754,5227,41,39,80
"17290",2110,1955,5238,127,135,262
"17291",2252,2135,5238,229,235,464
"17292",2021,1858,5238,68,68,136
"17293",1941,1812,5238,38,32,70
"17294",1943,1818,5238,40,38,78
"17295",1114,920,5241,145,90,235
"17296",2214,2018,5241,40,53,93
"17297",2208,2112,5242,56,62,118
"17298",2152,2102,5242,40,52,92
"17299",2303,2203,5242,111,113,224
"17300",2229,2122,5242,77,72,149
"17301",2250,2146,5242,98,96,194
"17302",2144,2047,5242,32,37,69
"17303",1706,1610,5245,54,56,110
"17304",1829,1720,5245,137,126,263
"17305",1808,1708,5245,116,114,230
"17306",1750,1645,5245,98,91,189
"17307",2013,1846,5246,36,41,77
"17308",2249,2110,5246,192,185,377
"17309",2033,1910,5246,56,65,121
"17310",1142,1006,5205,62,64,126
"17311",1746,1404,5210,39,44,83
"17312",2315,2149,5217,37,49,86
"17313",2001,1837,5223,46,57,103
"17314",18,2259,5224,113,124,237
"17315",1123,1012,5157,63,67,130
"17316",1142,1030,5157,82,85,167
"17317",1438,1118,5158,32,53,85
"17318",1440,1104,5158,34,39,73
"17319",1926,1810,5159,41,40,81
"17320",1918,1807,5159,31,37,68
"17321",57,2312,5162,90,112,202
"17322",2009,1629,5165,126,94,220
"17323",1847,1538,5165,44,43,87
"17324",2243,2023,5170,47,63,110
"17325",109,2331,5172,129,141,270
"17326",1243,1058,5173,58,63,121
"17327",2030,1847,5174,60,37,97
"17328",1953,1546,5176,182,151,333
"17329",2353,2257,5178,74,92,166
"17330",1831,1611,5180,122,65,187
"17331",1721,1610,5180,55,65,120
"17332",2102,1743,5181,40,43,83
"17333",1212,1059,5182,95,104,199
"17334",54,2054,5185,109,109,218
"17335",55,2104,5185,110,119,229
"17336",2337,2031,5186,34,46,80
"17337",2358,2052,5186,55,67,122
"17338",2041,1804,230,36,34,70
"17339",1919,1446,552,79,44,123
"17340",2002,1606,552,122,124,246
"17341",2010,1629,552,129,141,270
"17342",1915,1530,552,75,88,163
"17343",1845,1454,552,46,50,96
"17344",2200,1946,574,32,46,78
"17345",1524,1353,841,54,52,106
"17346",1200,931,855,45,41,86
"17347",1942,1610,1978,37,31,68
"17348",1832,1413,1824,66,58,124
"17349",1144,732,1776,78,77,155
"17350",1323,1131,362,184,201,385
"17351",2039,1840,422,39,40,79
"17352",1920,1700,644,145,120,265
"17353",2218,1906,1679,73,86,159
"17354",2238,1847,1828,42,62,104
"17355",2037,1635,1978,92,56,148
"17356",854,659,652,62,59,121
"17357",1424,1057,1170,38,32,70
"17358",1851,1453,1824,85,98,183
"17359",1731,1542,644,36,42,78
"17360",1741,1607,644,46,67,113
"17361",1758,1349,1824,32,34,66
"17362",2243,1838,1828,47,53,100
"17363",219,2233,2061,174,183,357
"17364",1449,1408,23,39,48,87
"17365",1922,1817,44,82,77,159
"17366",2159,1946,397,49,61,110
"17367",1211,1111,167,31,36,67
"17368",1004,906,231,49,56,105
"17369",1805,1652,3927,45,52,97
"17370",2316,2026,43,91,111,202
"17371",1835,1750,2189,40,50,90
"17372",1249,1101,2664,69,76,145
"17373",1709,1407,2878,54,67,121
"17374",1504,1414,23,54,54,108
"17375",1743,1649,40,43,49,92
"17376",2115,1932,1057,35,32,67
"17377",2024,1856,1508,164,166,330
"17378",2304,2002,274,49,62,111
"17379",1916,1712,2261,41,42,83
"17380",1351,1235,9,151,130,281
"17381",1347,1304,1185,37,39,76
"17382",2356,2216,931,36,61,97
"17383",1518,1127,734,48,52,100
"17384",1455,1410,23,45,50,95
"17385",1315,1220,20,80,80,160
"17386",1359,1304,24,59,64,123
"17387",1445,1349,28,50,49,99
"17388",1549,1456,32,49,56,105
"17389",2054,2002,40,234,242,476
"17390",1803,1710,42,33,40,73
"17391",1534,1449,2622,74,84,158
"17392",2123,2028,45,58,73,131
"17393",1907,1739,1508,87,89,176
"17394",1641,1428,1952,61,73,134
"17395",1958,1543,1819,58,73,131
"17396",2217,2113,426,47,63,110
"17397",2223,2108,426,53,58,111
"17398",958,644,466,38,44,82
"17399",1425,1252,865,80,57,137
"17400",1436,1339,865,91,104,195
"17401",1347,1246,865,42,51,93
"17402",1912,1805,1033,102,105,207
"17403",1835,1723,1033,65,63,128
"17404",2133,1818,1294,33,43,76
"17405",2347,2025,1294,167,170,337
"17406",1726,1400,1496,36,35,71
"17407",1633,1528,1740,43,48,91
"17408",1639,1531,1740,49,51,100
"17409",1724,1606,1740,94,86,180
"17410",808,650,1740,978,970,1948
"17411",1656,1524,1740,66,44,110
"17412",1848,1728,1903,663,653,1316
"17413",2238,2005,731,74,95,169
"17414",2120,1654,622,63,64,127
"17415",2147,1727,622,90,97,187
"17416",2149,1726,622,92,96,188
"17417",2230,1756,622,133,126,259
"17418",2053,1640,622,36,50,86
"17419",39,1955,622,262,245,507
"17420",2147,1748,622,90,118,208
"17421",1251,831,620,108,111,219
"17422",1955,1546,62,63,76,139
"17423",1451,1240,1011,84,70,154
"17424",1554,1115,1134,38,50,88
"17425",2315,2222,1145,47,72,119
"17426",1521,1131,1178,52,56,108
"17427",10,2112,1225,54,60,114
"17428",1432,1246,1231,65,81,146
"17429",1512,1148,1248,75,78,153
"17430",1846,1749,1488,42,58,100
"17431",1953,1829,1534,45,76,121
"17432",2053,1642,1546,41,52,93
"17433",2319,2224,1578,47,65,112
"17434",2331,2023,1586,76,83,159
"17435",1752,1442,1640,90,102,192
"17436",1408,1229,1663,51,59,110
"17437",2045,1917,59,85,98,183
"17438",1848,1741,1031,103,116,219
"17439",2301,2124,1406,37,54,91
"17440",16,2117,1424,59,47,106
"17441",1637,1405,1501,42,50,92
"17442",1941,1803,1534,35,48,83
"17443",1735,1523,1737,38,53,91
"17444",2317,2114,1033,119,144,263
"17445",1845,1528,1151,121,118,239
"17446",51,2126,1205,116,126,242
"17447",1541,1312,1237,156,162,318
"17448",2125,2011,1258,50,83,133
"17449",2335,2140,1533,31,35,66
"17450",1605,1205,1583,175,165,340
"17451",1835,1351,1670,51,41,92
"17452",20,2201,1712,41,46,87
"17453",819,641,1717,579,576,1155
"17454",1720,1257,1744,207,217,424
"17455",2037,1650,1027,66,65,131
"17456",1509,1135,1085,76,85,161
"17457",1719,1307,1123,45,62,107
"17458",1300,1003,1198,39,33,72
"17459",2348,2009,1230,47,59,106
"17460",2325,2231,1234,151,196,347
"17461",1139,930,1100,31,45,76
"17462",2039,1941,1145,80,91,171
"17463",1256,1002,1198,35,32,67
"17464",2325,2024,1219,39,59,98
"17465",2120,2017,1241,32,42,74
"17466",2352,2016,1498,73,81,154
"17467",155,2305,1552,95,95,190
"17468",2213,2125,1603,150,167,317
"17469",2302,1849,1658,48,64,112
"17470",2145,1748,1676,36,52,88
"17471",1932,1634,1682,80,64,144
"17472",1212,1008,1725,40,38,78
"17473",2322,2236,1731,69,81,150
"17474",937,756,1732,40,36,76
"17475",1553,1132,106,37,47,84
"17476",2344,1932,163,38,42,80
"17477",2010,1629,1027,39,44,83
"17478",2310,2046,1033,112,116,228
"17479",1713,1409,1045,36,43,79
"17480",44,2107,1056,50,72,122
"17481",1409,949,1075,101,114,215
"17482",1220,851,1077,105,126,231
"17483",2103,1816,1121,46,46,92
"17484",1733,1305,1123,49,50,99
"17485",948,848,1143,85,98,183
"17486",1815,1429,1159,93,89,182
"17487",2252,2029,1181,167,174,341
"17488",1508,1406,1197,47,56,103
"17489",2206,1958,1240,184,204,388
"17490",1128,1011,1257,39,61,100
"17491",1724,1412,1266,37,47,84
"17492",43,2125,1270,55,60,115
"17493",1958,1616,1439,98,101,199
"17494",2317,2152,1490,40,47,87
"17495",2343,2044,1588,58,69,127
"17496",1943,1546,1623,67,61,128
"17497",2037,1631,1653,199,185,384
"17498",1825,1557,1665,70,84,154
"17499",1452,1235,1669,73,80,153
"17500",1826,1356,1670,42,46,88
"17501",51,2211,1690,38,41,79
"17502",2037,1724,1700,82,89,171
"17503",1757,1406,1,227,271,498
"17504",1812,1549,1162,37,66,103
"17505",1257,900,1232,125,95,220
"17506",2209,2055,1258,99,132,231
"17507",2021,1758,1503,67,84,151
"17508",2256,1941,1586,44,41,85
"17509",1851,1611,1665,96,97,193
"17510",1442,1253,1669,53,98,151
"17511",2104,1847,1121,46,77,123
"17512",1934,1633,1176,47,53,100
"17513",1754,1435,1266,45,50,95
"17514",1722,1321,1621,37,47,84
"17515",1437,1126,1715,52,56,108
"17516",2355,2256,1717,73,111,184
"17517",9,2017,163,63,87,150
"17518",2042,1716,1027,71,91,162
"17519",2300,2107,1033,102,137,239
"17520",1739,1612,1036,99,107,206
"17521",2004,1655,1089,47,54,101
"17522",2207,1927,1091,39,37,76
"17523",1309,1036,1198,48,66,114
"17524",2346,1956,1235,44,46,90
"17525",2324,1932,1498,45,37,82
"17526",2336,1914,1550,40,54,94
"17527",1619,1301,1592,102,112,214
"17528",1812,1451,1624,34,36,70
"17529",1434,1139,1656,44,54,98
"17530",1946,1844,5,48,59,107
"17531",1706,1605,35,39,35,74
"17532",2158,2032,59,158,173,331
"17533",1545,1359,162,131,139,270
"17534",53,2057,163,107,127,234
"17535",1758,1548,1008,89,68,157
"17536",1205,1001,1100,57,76,133
"17537",1618,1159,1134,68,94,162
"17538",1438,947,1163,76,52,128
"17539",1432,1305,1164,66,70,136
"17540",1455,1348,1197,34,38,72
"17541",1346,1126,1198,85,116,201
"17542",2235,2033,1207,132,153,285
"17543",2159,2057,1233,36,32,68
"17544",2139,2022,1234,45,67,112
"17545",2141,2030,1241,53,55,108
"17546",2141,1923,1258,66,35,101
"17547",28,2112,1270,40,47,87
"17548",1506,1318,1273,87,88,175
"17549",13,2147,1424,56,77,133
"17550",28,2026,1504,46,55,101
"17551",1308,1129,1523,41,59,100
"17552",1849,1522,1576,120,137,257
"17553",1720,1337,1590,36,46,82
"17554",1244,1119,1655,36,48,84
"17555",2313,2015,1661,53,65,118
"17556",21,2305,1673,94,110,204
"17557",2152,1751,1676,43,55,98
"17558",1848,1613,1682,36,43,79
"17559",2,1945,1718,101,110,211
"17560",1224,1046,1723,79,81,160
"17561",1707,1506,1727,33,33,66
"17562",1127,818,1741,35,48,83
"17563",1811,1344,1003,32,49,81
"17564",2151,1737,1004,84,102,186
"17565",320,2332,1054,122,147,269
"17566",1847,1417,1191,58,52,110
"17567",1716,1544,1451,47,64,111
"17568",55,2059,1504,73,88,161
"17569",2340,2138,1533,36,33,69
"17570",2049,1837,1597,41,47,88
"17571",1811,1346,1670,37,37,74
"17572",2341,1926,1676,152,150,302
"17573",2034,1833,1707,51,52,103
"17574",202,3,1712,143,168,311
"17575",1943,1827,151,33,49,82
"17576",1715,1605,1112,40,35,75
"17577",2155,1714,1137,38,40,78
"17578",2024,1912,1145,65,62,127
"17579",1933,1625,1176,49,45,94
"17580",946,828,1480,38,63,101
"17581",1720,1341,1590,36,50,86
"17582",1828,1550,1665,73,77,150
"17583",1851,1714,1031,101,84,185
"17584",31,2051,1056,37,56,93
"17585",1557,1429,1097,57,84,141
"17586",2033,1933,1145,39,48,87
"17587",1109,936,1182,44,66,110
"17588",2346,2020,1205,51,60,111
"17589",128,2353,1284,125,143,268
"17590",2357,2059,1588,72,84,156
"17591",2026,1554,62,87,84,171
"17592",2016,1554,106,309,309,618
"17593",2210,1733,1004,103,98,201
"17594",2338,2043,1225,63,73,136
"17595",2131,2029,1241,63,74,137
"17596",1649,1336,1640,35,46,81
"17597",1416,1109,1715,31,39,70
"17598",1944,1843,5,46,58,104
"17599",1354,1231,1023,40,60,100
"17600",1714,1333,1159,32,33,65
"17601",2213,2110,1177,70,85,155
"17602",2001,1723,1503,46,49,95
"17603",1707,1347,1572,33,47,80
"17604",2348,1931,163,42,41,83
"17605",2318,1912,1004,171,197,368
"17606",35,2050,1056,43,55,98
"17607",1459,1105,1062,47,53,100
"17608",1305,901,1075,37,66,103
"17609",1148,942,1100,40,57,97
"17610",1724,1601,1112,49,31,80
"17611",2152,1748,1131,45,33,78
"17612",1510,1336,1164,104,101,205
"17613",18,2057,1205,83,97,180
"17614",2104,1836,1207,41,36,77
"17615",2327,2156,1258,172,188,360
"17616",1721,1044,1297,59,34,93
"17617",30,2151,1424,73,81,154
"17618",1627,1149,1499,107,79,186
"17619",2343,2208,1524,41,53,94
"17620",33,2252,1533,89,107,196
"17621",1819,1450,1572,105,110,215
"17622",1732,1324,1590,48,33,81
"17623",1729,1411,1640,65,71,136
"17624",2345,2223,1673,58,68,126
"17625",2145,1738,1676,36,42,78
"17626",2029,1819,1707,46,38,84
"17627",2328,2156,1717,48,51,99
"17628",1001,820,52,31,45,76
"17629",1946,1506,62,43,36,79
"17630",1951,1627,1015,41,42,83
"17631",2212,1825,1131,65,70,135
"17632",1218,849,1160,98,84,182
"17633",1413,946,1163,51,51,102
"17634",2128,1942,1207,65,102,167
"17635",1848,1537,1266,121,132,253
"17636",1523,1244,1272,71,74,145
"17637",1431,1254,1273,52,64,116
"17638",2322,2141,1406,58,71,129
"17639",1600,1133,1499,80,63,143
"17640",114,2259,1552,54,89,143
"17641",2304,2206,1578,36,47,83
"17642",1750,1306,1621,68,36,104
"17643",2359,2138,1628,122,158,280
"17644",2251,1829,1658,37,44,81
"17645",2343,2046,1661,83,96,179
"17646",1958,1631,1700,43,36,79
"17647",29,2317,1717,109,132,241
"17648",2103,1642,1004,39,47,86
"17649",211,2215,1054,53,70,123
"17650",13,1950,1246,44,45,89
"17651",55,2103,1268,112,133,245
"17652",2136,1732,1546,70,102,172
"17653",2142,2038,1241,84,93,177
"17654",2303,1933,1496,39,43,82
"17655",1218,1111,1679,122,121,243
"17656",1949,1648,1089,37,53,90
"17657",2255,2052,1181,178,197,375
"17658",1930,1829,1488,90,99,189
"17659",1716,1418,1600,43,53,96
"17660",1459,1036,1,49,61,110
"17661",1153,854,1160,65,84,149
"17662",2346,2228,1490,78,88,166
"17663",2348,1929,1658,99,109,208
"17664",1502,1343,1023,106,123,229
"17665",1746,1403,1068,58,68,126
"17666",2327,1954,1074,53,59,112
"17667",1131,829,1160,43,59,102
"17668",13,2017,1546,227,267,494
"17669",2045,1616,62,102,106,208
"17670",1446,1218,1043,37,53,90
"17671",1506,1403,1197,41,48,89
"17672",1418,1212,1231,48,37,85
"17673",1338,1249,1272,45,59,104
"17674",1715,1526,1277,57,41,98
"17675",945,818,1444,40,53,93
"17676",1956,1736,1503,48,66,114
"17677",2250,1934,1586,35,34,69
"17678",1423,1302,1723,201,212,413
"17679",2214,1735,1004,110,100,210
"17680",2349,2245,1057,91,95,186
"17681",118,2053,1100,122,115,237
"17682",2050,1947,1233,41,37,78
"17683",2247,2149,1247,33,39,72
"17684",1414,949,1258,34,34,68
"17685",2341,1938,1268,38,48,86
"17686",1851,1505,1439,39,35,74
"17687",1838,1427,1559,114,117,231
"17688",16,1927,1658,127,107,234
"17689",1725,1608,33,45,38,83
"17690",1238,1051,52,197,196,393
"17691",1432,1019,1258,52,64,116
"17692",2337,1925,1268,34,35,69
"17693",1205,759,1281,37,44,81
"17694",1807,1536,1423,34,51,85
"17695",1938,1541,1559,174,191,365
"17696",1655,1230,1574,57,55,112
"17697",2225,2037,1609,127,157,284
"17698",2310,1915,1676,177,200,377
"17699",1819,1416,1699,32,51,83
"17700",2326,1941,1074,52,46,98
"17701",1242,1023,1075,46,53,99
"17702",15,1953,1100,59,55,114
"17703",1854,1451,1137,126,113,239
"17704",1623,1208,1196,53,61,114
"17705",1432,1211,1231,62,36,98
"17706",2045,1825,1249,38,35,73
"17707",1448,956,1258,68,41,109
"17708",1540,1441,1261,35,31,66
"17709",1334,1107,1403,31,37,68
"17710",1823,1456,1471,86,101,187
"17711",1456,1057,1527,41,37,78
"17712",1648,1210,1574,50,35,85
"17713",1357,1002,1583,60,57,117
"17714",2318,1942,1586,63,42,105
"17715",2237,1902,1606,196,187,383
"17716",2324,1839,1658,75,59,134
"17717",1225,859,1696,105,104,209
"17718",2340,1852,1706,72,57,129
"17719",2322,2149,1717,51,49,100
"17720",2227,1933,1017,33,33,66
"17721",2113,1830,1121,59,56,115
"17722",2109,1845,1181,72,70,142
"17723",2103,1925,1207,54,38,92
"17724",10,1937,1246,41,32,73
"17725",1835,1641,1285,60,51,111
"17726",2342,2147,1406,62,56,118
"17727",2221,1821,1531,71,70,141
"17728",2006,1824,1689,43,34,77
"17729",1438,1213,1118,54,48,102
"17730",2056,1831,1121,41,56,97
"17731",1731,1119,1573,66,64,130
"17732",1851,1659,1651,122,149,271
"17733",2212,2049,47,76,99,175
"17734",2312,2132,1406,32,41,73
"17735",1206,926,1585,42,36,78
"17736",21,2114,1704,106,124,230
"17737",24,2311,1737,108,121,229
"17738",2154,2025,47,58,75,133
"17739",1557,1333,1043,108,128,236
"17740",56,2321,1140,107,126,233
"17741",1659,1306,1178,155,151,306
"17742",2254,1921,1192,40,31,71
"17743",1113,953,1677,45,48,93
"17744",1515,1229,810,60,79,139
"17745",1745,1445,810,450,458,908
"17746",1957,1649,1846,55,50,105
"17747",2335,2056,8,297,319,616
"17748",1738,1447,1675,68,77,145
"17749",1916,1619,8,43,47,90
"17750",1704,1406,1675,34,36,70
"17751",2239,1823,54,128,53,181
"17752",1312,1012,1590,31,32,63
"17753",1102,807,2010,117,127,244
"17754",1823,1533,1675,113,123,236
"17755",1929,1611,8,56,39,95
"17756",2121,1815,54,50,45,95
"17757",1049,746,810,39,39,78
"17758",1338,1011,1590,57,31,88
"17759",1750,1457,1675,80,87,167
"17760",2017,1715,1846,78,76,154
"17761",1719,1423,1590,278,283,561
"17762",2215,1823,4926,76,72,148
"17763",1848,1502,4927,135,137,272
"17764",1944,1554,4928,47,42,89
"17765",1921,1539,4928,31,34,65
"17766",2021,1705,4928,91,120,211
"17767",2058,1723,4928,128,138,266
"17768",1431,1240,4956,55,45,100
"17769",1152,820,5002,37,55,92
"17770",1350,1024,5386,36,54,90
"17771",1455,1330,145,68,65,133
"17772",1436,1318,145,49,53,102
"17773",2059,1947,147,33,48,81
"17774",2226,2108,147,120,129,249
"17775",1609,1451,145,142,146,288
"17776",2103,1815,292,43,45,88
"17777",1406,1121,298,35,42,77
"17778",1724,1428,294,82,78,160
"17779",2126,1821,292,69,56,125
"17780",1455,1150,298,92,79,171
"17781",1659,1409,286,111,109,220
"17782",1750,1449,294,100,91,191
"17783",2202,1848,292,105,83,188
"17784",2243,1958,296,68,70,138
"17785",1444,1157,298,81,86,167
"17786",2129,1934,2870,159,119,278
"17787",1957,1854,2870,67,79,146
"17788",2158,2026,2870,188,171,359
"17789",1208,1058,2958,43,43,86
"17790",1246,1121,2958,81,66,147
"17791",1217,1111,2958,52,56,108
"17792",1203,1054,2958,38,39,77
"17793",1410,1308,3216,55,63,118
"17794",1410,1302,3216,55,57,112
"17795",1350,1242,3216,35,37,72
"17796",1402,1305,3216,47,60,107
"17797",1831,1726,3217,36,46,82
"17798",802,706,3265,57,66,123
"17799",1409,1307,3265,424,427,851
"17800",824,706,3328,704,691,1395
"17801",2229,2118,3328,109,103,212
"17802",2132,2026,3328,52,51,103
"17803",2132,2030,3328,52,55,107
"17804",2315,2210,3328,155,155,310
"17805",1743,1620,3390,53,40,93
"17806",1731,1617,3390,41,37,78
"17807",1757,1625,3390,67,45,112
"17808",1810,1703,3390,80,83,163
"17809",2137,2020,3390,287,280,567
"17810",2257,2010,3717,97,80,177
"17811",2153,1922,3717,33,32,65
"17812",2204,1934,3717,44,44,88
"17813",2159,1930,3717,39,40,79
"17814",2251,2021,3717,91,91,182
"17815",1520,1402,3719,55,77,132
"17816",1505,1335,3719,40,50,90
"17817",1638,1524,3719,133,159,292
"17818",2233,2114,3724,48,69,117
"17819",2314,2140,3724,89,95,184
"17820",1953,1726,3786,73,86,159
"17821",1916,1641,3796,291,291,582
"17822",1532,1312,3796,67,82,149
"17823",1501,1225,3796,36,35,71
"17824",4,1947,112,129,132,261
"17825",2208,2113,218,83,98,181
"17826",1925,1824,1366,55,54,109
"17827",1632,1401,3242,47,46,93
"17828",1736,1320,3085,46,40,86
"17829",902,739,621,37,39,76
"17830",1336,1249,1509,66,64,130
"17831",1258,1125,1662,38,50,88
"17832",1645,1547,36,45,47,92
"17833",1816,1726,40,76,86,162
"17834",2106,2013,44,186,193,379
"17835",2007,1912,48,62,72,134
"17836",24,2031,112,149,176,325
"17837",1655,1550,988,80,85,165
"17838",1936,1824,513,56,64,120
"17839",1429,1317,581,44,52,96
"17840",2017,1728,471,257,268,525
"17841",2234,1946,1191,74,96,170
"17842",9,2122,1674,39,42,81
"17843",1818,1702,1597,53,62,115
"17844",1711,1311,1989,31,41,72
"17845",1528,1435,3800,68,70,138
"17846",1305,1142,111,65,67,132
"17847",1740,1608,2660,105,103,208
"17848",1312,1204,1436,42,34,76
"17849",1717,1308,2072,37,38,75
"17850",957,911,1,42,46,88
"17851",1235,1139,20,40,39,79
"17852",1457,1324,19,62,59,121
"17853",1123,959,410,58,59,117
"17854",1812,1715,1300,32,40,72
"17855",1541,1424,581,116,119,235
"17856",1321,1238,1509,51,53,104
"17857",2132,2042,56,37,42,79
"17858",1500,1407,23,35,42,77
"17859",1628,1525,988,53,60,113
"17860",1213,1108,1231,138,128,266
"17861",1632,1336,471,32,36,68
"17862",1255,1113,1662,35,38,73
"17863",2104,2020,47,39,50,89
"17864",1502,1407,30,37,37,74
"17865",1735,1636,40,35,36,71
"17866",1433,1306,19,38,41,79
"17867",1741,1616,31,41,46,87
"17868",1501,1402,23,36,37,73
"17869",130,2232,55,55,62,117
"17870",2112,2016,207,32,36,68
"17871",2109,2007,216,39,52,91
"17872",2040,1909,41,40,54,94
"17873",1600,1514,27,35,39,74
"17874",2102,2014,47,37,39,76
"17875",1131,1039,16,31,39,70
"17876",1703,1617,36,63,77,140
"17877",1842,1755,42,72,85,157
"17878",2039,1944,48,99,104,203
"17879",2102,2014,50,92,104,196
"17880",21,2022,104,146,167,313
"17881",2309,1957,45,44,47,91
"17882",2307,2211,55,37,41,78
"17883",2156,2101,1271,51,56,107
"17884",1631,1528,1561,46,53,99
"17885",1150,1018,523,35,53,88
"17886",1649,1342,21,34,37,71
"17887",2254,1952,959,49,52,101
"17888",2242,2040,1568,32,60,92
"17889",1243,1148,198,68,73,141
"17890",2039,1946,586,39,46,85
"17891",1907,1800,513,32,45,77
"17892",2339,2047,258,99,102,201
"17893",1801,1709,42,31,39,70
"17894",2226,2051,239,56,56,112
"17895",15,2022,104,140,167,307
"17896",1507,1401,23,37,31,68
"17897",1619,1358,3242,34,43,77
"17898",1805,1628,1227,65,78,143
"17899",2022,1642,3816,37,62,99
"17900",1936,1815,2185,36,45,81
"17901",1910,1833,2698,50,63,113
"17902",2317,2210,239,92,135,227
"17903",2340,1933,1160,105,118,223
"17904",1306,1214,1436,36,44,80
"17905",1625,1517,1359,40,42,82
"17906",1222,1115,1756,37,40,77
"17907",2329,2031,2341,99,106,205
"17908",1919,1511,2072,159,161,320
"17909",1902,1813,2399,37,43,80
"17910",1857,1812,460,37,42,79
"17911",1445,1306,231,80,71,151
"17912",2111,2021,47,46,46,92
"17913",842,744,4,42,44,86
"17914",935,845,8,35,45,80
"17915",1543,1451,24,168,171,339
"17916",1756,1634,40,56,34,90
"17917",2144,2040,50,134,130,264
"17918",2251,2142,60,56,42,98
"17919",2312,2003,45,47,53,100
"17920",2111,2016,1366,161,166,327
"17921",1623,1517,1561,38,42,80
"17922",2339,2236,1949,109,111,220
"17923",2202,2103,43,112,143,255
"17924",1436,1340,873,41,70,111
"17925",2315,2007,959,70,67,137
"17926",1426,1332,471,36,42,78
"17927",2048,1953,586,48,53,101
"17928",2350,2254,1034,125,129,254
"17929",2112,2021,207,42,46,88
"17930",1932,1838,1456,67,68,135
"17931",2259,2011,258,59,66,125
"17932",2136,2056,460,196,206,402
"17933",1831,1634,31,81,54,135
"17934",2338,2230,1949,108,105,213
"17935",2040,1919,1464,100,104,204
"17936",1908,1754,513,33,39,72
"17937",1851,1654,1050,51,54,105
"17938",1457,1352,787,32,42,74
"17939",1125,1014,907,60,64,124
"17940",2130,2042,47,65,67,132
"17941",2218,2130,56,83,90,173
"17942",2241,2150,60,46,50,96
"17943",23,2311,239,173,196,369
"17944",1654,1540,495,59,75,134
"17945",200,2200,104,245,265,510
"17946",2324,2225,1949,94,100,194
"17947",2043,1926,43,33,46,79
"17948",2245,2049,1568,35,69,104
"17949",920,705,1799,50,65,115
"17950",2039,1950,586,39,50,89
"17951",2018,1814,1118,68,84,152
"17952",1515,1406,114,100,111,211
"17953",1240,1058,1403,60,73,133
"17954",1421,1335,994,41,50,91
"17955",1052,1005,1231,57,65,122
"17956",1858,1807,1456,33,37,70
"17957",28,2103,762,48,78,126
"17958",1425,1128,1243,70,88,158
"17959",1940,1856,33,170,176,346
"17960",2158,2111,51,38,41,79
"17961",851,801,4,51,61,112
"17962",919,828,6,49,58,107
"17963",1707,1619,38,42,49,91
"17964",1802,1713,40,62,73,135
"17965",1910,1817,46,40,47,87
"17966",2149,2103,50,139,153,292
"17967",1158,1041,317,148,161,309
"17968",1613,1449,578,38,44,82
"17969",2142,2016,938,32,41,73
"17970",2227,1828,3168,32,53,85
"17971",1432,1121,332,32,41,73
"17972",1714,1427,3251,44,62,106
"17973",2341,2247,55,71,77,148
"17974",2339,2245,468,114,120,234
"17975",1607,1504,239,32,39,71
"17976",1412,1124,9,52,59,111
"17977",812,705,459,32,50,82
"17978",1150,1023,1107,40,38,78
"17979",1709,1545,1149,39,40,79
"17980",2307,2009,954,32,39,71
"17981",1219,1122,504,39,42,81
"17982",1723,1520,1305,78,95,173
"17983",1941,1825,861,36,40,76
"17984",19,2027,45,59,77,136
"17985",2012,1724,31,97,109,206
"17986",137,2249,1201,72,79,151
"17987",1359,1115,2279,64,80,144
"17988",2157,2106,51,37,36,73
"17989",1659,1533,578,84,88,172
"17990",1651,1528,27,51,58,109
"17991",1542,1438,980,72,68,140
"17992",2228,1832,3168,33,57,90
"17993",1509,1406,23,44,41,85
"17994",1717,1547,1149,47,42,89
"17995",2201,1946,3236,41,56,97
"17996",1753,1702,1226,43,52,95
"17997",1757,1658,3588,67,63,130
"17998",1417,1126,1258,32,46,78
"17999",1625,1514,3533,40,39,79
"18000",2143,2038,3499,48,58,106
"18001",20,2029,762,40,44,84
"18002",1507,1415,30,42,45,87
"18003",1842,1748,44,42,48,90
"18004",1907,1815,46,37,45,82
"18005",1709,1546,1149,39,41,80
"18006",2209,2001,3236,49,71,120
"18007",1826,1710,955,86,90,176
"18008",1821,1731,3588,91,96,187
"18009",1124,1044,823,39,44,83
"18010",27,2006,3168,152,151,303
"18011",1831,1534,21,136,149,285
"18012",20,2024,45,60,74,134
"18013",2112,1922,43,32,42,74
"18014",2244,2207,1346,109,117,226
"18015",2251,2108,1721,86,88,174
"18016",2247,2204,51,87,94,181
"18017",40,2042,3168,165,187,352
"18018",1408,1021,403,38,61,99
"18019",2146,1955,43,66,75,141
"18020",1935,1644,31,60,69,129
"18021",2232,2047,1721,67,67,134
"18022",1447,1354,28,52,54,106
"18023",2326,1921,3168,91,106,197
"18024",1942,1854,41,32,44,76
"18025",1541,1438,198,36,63,99
"18026",2309,2017,954,34,47,81
"18027",1550,1444,213,70,64,134
"18028",1745,1648,1226,35,38,73
"18029",25,2026,45,65,76,141
"18030",1844,1742,425,44,72,116
"18031",158,2308,1201,93,98,191
"18032",1118,1037,3498,33,37,70
"18033",2015,1932,1347,55,62,117
"18034",1134,1040,3553,34,40,74
"18035",858,759,1782,43,44,87
"18036",1130,1043,2345,35,43,78
"18037",2324,2223,4086,42,58,100
"18038",1755,1655,4087,81,75,156
"18039",1747,1632,4087,71,52,123
"18040",2051,2006,4087,257,266,523
"18041",2322,2235,4088,63,70,133
"18042",2309,2214,4088,50,49,99
"18043",7,2319,4088,110,114,224
"18044",1638,1513,4094,47,38,85
"18045",1348,1206,4095,198,196,394
"18046",1609,1439,4096,189,199,388
"18047",2021,1842,4097,52,57,109
"18048",1059,755,4105,39,35,74
"18049",1101,800,4105,41,40,81
"18050",1120,809,4105,60,49,109
"18051",1647,1329,4105,387,369,756
"18052",2015,1725,4107,45,58,103
"18053",2213,1925,4107,149,165,314
"18054",2226,1859,4107,176,152,328
"18055",203,2326,4108,293,316,609
"18056",2134,1828,4108,44,38,82
"18057",2201,1855,4108,71,65,136
"18058",2210,1839,4108,80,49,129
"18059",2252,1955,4108,122,125,247
"18060",1923,1823,4108,145,153,298
"18061",2230,1920,4110,331,325,656
"18062",1921,1618,4110,144,143,287
"18063",924,749,4114,37,34,71
"18064",927,757,4114,40,42,82
"18065",1448,1307,4114,362,352,714
"18066",1459,1321,4115,34,31,65
"18067",1546,1411,4115,81,81,162
"18068",1848,1711,4116,56,56,112
"18069",1826,1649,4116,34,34,68
"18070",2243,2109,4116,268,269,537
"18071",1959,1820,4117,38,35,73
"18072",2047,1911,4117,86,86,172
"18073",2013,1820,4117,52,35,87
"18074",2233,2049,4121,49,64,113
"18075",1911,1613,4125,96,98,194
"18076",1910,1716,4126,90,86,176
"18077",1826,1637,4126,46,47,93
"18078",1102,955,4131,37,45,82
"18079",1601,1452,4131,338,342,680
"18080",1339,1217,4132,60,52,112
"18081",1434,1305,4132,115,100,215
"18082",1430,1328,4132,111,123,234
"18083",1742,1602,4133,75,47,122
"18084",1737,1615,4133,72,60,132
"18085",1711,1552,4133,44,37,81
"18086",1740,1630,4133,73,75,148
"18087",1815,1719,4133,108,124,232
"18088",1738,1628,4133,73,73,146
"18089",2125,2023,4134,110,123,233
"18090",2319,2213,4135,41,48,89
"18091",1230,1136,4138,40,51,91
"18092",1245,1151,4138,55,66,121
"18093",1407,1311,4139,64,65,129
"18094",1551,1439,4139,168,153,321
"18095",1512,1414,4139,129,128,257
"18096",1415,1316,4139,74,70,144
"18097",1549,1446,4140,34,31,65
"18098",1712,1547,4140,117,92,209
"18099",1709,1607,4140,114,112,226
"18100",1647,1550,4140,92,95,187
"18101",2116,2022,4141,37,47,84
"18102",2146,2011,4141,67,36,103
"18103",2117,2013,4141,38,38,76
"18104",1107,1003,4142,52,63,115
"18105",1611,1503,4142,91,86,177
"18106",1816,1648,4143,36,43,79
"18107",1953,1832,4143,133,147,280
"18108",2231,2108,4143,291,303,594
"18109",1805,1453,4147,54,53,107
"18110",2106,1754,4147,227,228,455
"18111",1804,1447,4147,45,41,86
"18112",1750,1442,4147,31,36,67
"18113",2047,1734,4147,183,181,364
"18114",27,2121,4148,64,71,135
"18115",100,2136,4148,127,116,243
"18116",45,2141,4148,112,121,233
"18117",11,2104,4148,78,84,162
"18118",1632,1346,4150,92,56,148
"18119",1920,1722,4150,251,263,514
"18120",1528,1204,4150,78,99,177
"18121",2217,2011,4151,52,56,108
"18122",2353,2236,4151,220,216,436
"18123",1911,1555,4151,107,100,207
"18124",2248,2106,4152,372,391,763
"18125",106,2137,4155,130,147,277
"18126",1820,1420,4164,101,75,176
"18127",2345,2031,4164,253,271,524
"18128",1220,1105,4192,41,50,91
"18129",1254,959,4193,53,59,112
"18130",2236,1916,4196,288,283,571
"18131",1808,1654,4198,241,239,480
"18132",1502,1336,4198,55,41,96
"18133",1456,1345,4198,49,50,99
"18134",2138,1816,4200,102,101,203
"18135",2040,1712,4200,44,37,81
"18136",2319,2012,4200,205,217,422
"18137",2140,1819,4201,257,266,523
"18138",2336,2250,4202,109,110,219
"18139",2,2034,4204,58,49,107
"18140",2,2051,4204,58,66,124
"18141",1824,1531,4204,113,121,234
"18142",1211,854,4206,53,70,123
"18143",1136,823,4206,37,58,95
"18144",1343,1230,4207,36,50,86
"18145",1756,1632,4208,79,78,157
"18146",1710,1553,4208,33,39,72
"18147",951,851,4211,33,36,69
"18148",1515,1349,4212,80,54,134
"18149",1527,1424,4212,85,84,169
"18150",1458,1346,4212,61,51,112
"18151",1754,1630,4214,73,50,123
"18152",2012,1911,4214,196,196,392
"18153",2121,2025,4214,280,285,565
"18154",2306,2218,4214,385,398,783
"18155",2248,2150,4215,138,145,283
"18156",10,2317,4215,220,232,452
"18157",2252,2203,4215,142,158,300
"18158",2224,2121,4215,114,116,230
"18159",2302,2211,4216,36,46,82
"18160",1424,1111,4218,53,56,109
"18161",1850,1530,4218,74,75,149
"18162",1810,1503,4218,34,48,82
"18163",1915,1539,4218,94,78,172
"18164",1941,1847,4220,51,57,108
"18165",1636,1514,4221,37,44,81
"18166",1752,1448,4222,107,118,225
"18167",1707,1340,4222,62,50,112
"18168",1926,1625,4222,157,173,330
"18169",1653,1346,4222,48,56,104
"18170",2146,1838,4222,343,348,691
"18171",2113,1750,4223,40,34,74
"18172",2157,1846,4223,84,90,174
"18173",2206,1856,4223,93,100,193
"18174",1705,1602,4225,93,92,185
"18175",1738,1601,4231,88,61,149
"18176",1751,1452,4232,42,37,79
"18177",1823,1529,4232,62,64,126
"18178",1815,1518,4232,44,43,87
"18179",1825,1532,4232,64,67,131
"18180",2014,1716,4232,175,171,346
"18181",1751,1534,4235,45,44,89
"18182",1738,1536,4235,32,46,78
"18183",1808,1717,4236,98,107,205
"18184",1335,1213,4238,37,43,80
"18185",1749,1512,4239,128,127,255
"18186",1814,1520,4241,105,120,225
"18187",2031,1708,4248,101,93,194
"18188",1957,1726,4250,96,101,197
"18189",1535,1240,4253,149,155,304
"18190",1401,1044,4253,55,39,94
"18191",1639,1337,4253,214,212,426
"18192",1406,1113,4253,60,68,128
"18193",1151,836,4253,45,61,106
"18194",914,805,4254,37,45,82
"18195",1537,1335,4256,47,46,93
"18196",1705,1530,4256,165,190,355
"18197",2105,1741,4261,40,36,76
"18198",2058,1742,4261,33,37,70
"18199",1542,1311,4262,303,326,629
"18200",1835,1629,4263,54,59,113
"18201",2155,2036,4265,32,41,73
"18202",2145,2023,4265,32,38,70
"18203",1206,919,4274,102,119,221
"18204",2003,1615,4275,55,40,95
"18205",2002,1630,4275,54,55,109
"18206",2104,1735,4275,86,84,170
"18207",1236,1056,4282,65,86,151
"18208",1539,1402,4282,225,249,474
"18209",1541,1413,4289,97,83,180
"18210",1646,1456,4291,273,281,554
"18211",1356,1214,4291,103,119,222
"18212",1340,1129,4291,87,74,161
"18213",1639,1449,4291,256,262,518
"18214",1250,1116,4292,149,146,295
"18215",1745,1627,4293,79,72,151
"18216",1758,1628,4293,92,73,165
"18217",1801,1714,4295,64,86,150
"18218",1235,1149,4302,65,44,109
"18219",2144,2048,4304,71,73,144
"18220",2158,2109,4304,85,94,179
"18221",2333,2245,4304,180,190,370
"18222",2123,2037,4307,74,82,156
"18223",2114,1928,4309,634,628,1262
"18224",1155,1032,4309,75,92,167
"18225",1602,1413,4309,322,313,635
"18226",103,2313,4310,118,108,226
"18227",944,833,4311,58,63,121
"18228",1611,1440,4312,284,270,554
"18229",1608,1503,4312,283,293,576
"18230",1819,1700,4314,55,50,105
"18231",2307,2150,4315,136,135,271
"18232",2159,2035,4315,68,60,128
"18233",2213,2105,4315,82,90,172
"18234",2142,2025,4315,51,50,101
"18235",2206,2056,4315,75,81,156
"18236",2141,2025,4315,50,50,100
"18237",1513,1355,4315,36,45,81
"18238",1528,1206,4316,69,71,140
"18239",1501,1139,4316,42,44,86
"18240",1749,1422,4316,214,209,423
"18241",1458,1132,4316,39,37,76
"18242",2100,1737,4318,204,202,406
"18243",1813,1520,4319,34,45,79
"18244",1420,1046,4320,67,41,108
"18245",1401,1058,4320,48,53,101
"18246",1626,1325,4320,195,200,395
"18247",55,2152,4321,74,77,151
"18248",33,2126,4321,52,51,103
"18249",201,2304,4321,202,209,411
"18250",1629,1511,4323,299,246,545
"18251",1928,1846,4324,48,31,79
"18252",1950,1913,4324,70,58,128
"18253",2148,2121,4324,188,186,374
"18254",1519,1210,4325,68,75,143
"18255",1112,1003,4327,31,38,69
"18256",1738,1621,4328,67,58,125
"18257",1756,1611,4328,83,48,131
"18258",1754,1644,4328,81,81,162
"18259",2125,2015,4329,123,125,248
"18260",2107,2001,4329,105,111,216
"18261",2229,2103,4329,187,173,360
"18262",2055,1947,4329,93,97,190
"18263",2029,1913,4329,67,63,130
"18264",1954,1848,4329,32,38,70
"18265",2147,2046,4329,147,156,303
"18266",1819,1646,4331,45,56,101
"18267",1844,1705,4331,70,75,145
"18268",1917,1738,4331,103,108,211
"18269",1844,1505,4332,88,95,183
"18270",1125,947,4333,35,42,77
"18271",1627,1451,4333,339,346,685
"18272",1700,1529,4334,64,74,138
"18273",1944,1817,4335,85,102,187
"18274",1850,1712,4335,46,52,98
"18275",1908,1719,4335,64,59,123
"18276",1928,1752,4335,84,92,176
"18277",2228,2057,4336,131,146,277
"18278",2106,1915,4336,49,44,93
"18279",2148,2012,4336,91,101,192
"18280",2112,1927,4336,55,56,111
"18281",2346,2216,4337,34,46,80
"18282",15,2244,4337,63,74,137
"18283",2351,2219,4337,39,49,88
"18284",1839,1733,4340,44,53,97
"18285",1834,1723,4340,39,43,82
"18286",1901,1751,4340,66,71,137
"18287",2039,1851,4340,45,61,106
"18288",1624,1327,4341,334,337,671
"18289",2315,2023,4342,40,48,88
"18290",36,2148,4342,84,96,180
"18291",2318,2027,4342,43,52,95
"18292",2319,2024,4342,44,49,93
"18293",2318,2024,4342,43,49,92
"18294",2318,2027,4342,43,52,95
"18295",2315,2159,4342,39,34,73
"18296",1335,1200,4344,37,35,72
"18297",1350,1225,4344,52,60,112
"18298",2345,2040,4345,38,49,87
"18299",1720,1541,4345,62,59,121
"18300",1748,1609,4345,89,86,175
"18301",1740,1609,4345,82,87,169
"18302",1921,1741,4345,79,64,143
"18303",1943,1825,4345,108,115,223
"18304",2254,2130,4346,180,195,375
"18305",2119,1927,4346,85,72,157
"18306",2156,2034,4346,124,139,263
"18307",2033,1910,4346,39,55,94
"18308",2050,1904,4346,56,49,105
"18309",2043,1915,4346,51,60,111
"18310",1959,1849,4348,79,79,158
"18311",2,2054,4349,64,79,143
"18312",2337,2021,4349,39,46,85
"18313",1849,1542,4350,31,32,63
"18314",1851,1540,4350,36,33,69
"18315",1908,1600,4350,55,53,108
"18316",1417,1324,4352,119,119,238
"18317",1353,1252,4352,93,87,180
"18318",1442,1349,4352,142,144,286
"18319",1743,1639,4353,51,42,93
"18320",1726,1636,4353,36,41,77
"18321",1807,1705,4353,82,75,157
"18322",2023,1932,4353,210,212,422
"18323",2253,2155,4354,44,40,84
"18324",1349,1247,4356,196,212,408
"18325",2329,2215,4357,62,60,122
"18326",2323,2208,4357,56,53,109
"18327",2328,2204,4358,54,44,98
"18328",2328,2224,4358,54,64,118
"18329",1333,1204,4358,32,34,66
"18330",1939,1816,4358,398,406,804
"18331",1748,1613,4358,287,283,570
"18332",1606,1437,4358,155,157,312
"18333",2342,2211,4359,55,51,106
"18334",1832,1620,4359,57,45,102
"18335",1239,1048,4362,68,43,111
"18336",1504,1340,4363,39,43,82
"18337",1528,1350,4363,63,53,116
"18338",1549,1429,4363,84,92,176
"18339",1836,1713,4364,61,68,129
"18340",1956,1829,4364,141,144,285
"18341",2147,2019,4365,59,64,123
"18342",2213,2039,4365,85,84,169
"18343",2143,2020,4365,55,65,120
"18344",1850,1746,4368,499,511,1010
"18345",1406,1301,4368,217,226,443
"18346",2040,1927,4369,56,57,113
"18347",2050,1943,4369,64,73,137
"18348",2108,1958,4369,84,88,172
"18349",2043,1908,4370,54,53,107
"18350",2107,1917,4370,71,57,128
"18351",2120,1959,4370,58,44,102
"18352",2114,2005,4370,52,50,102
"18353",2239,2140,4370,139,145,284
"18354",1447,1133,4371,40,53,93
"18355",1006,856,4372,74,86,160
"18356",1737,1622,4373,366,367,733
"18357",1506,1347,4374,58,57,115
"18358",1834,1725,4375,44,55,99
"18359",1839,1724,4375,49,54,103
"18360",1837,1721,4375,39,41,80
"18361",2244,2132,4376,69,77,146
"18362",2242,2127,4376,67,72,139
"18363",2225,2107,4376,50,52,102
"18364",2217,2101,4376,42,46,88
"18365",2215,2055,4376,40,40,80
"18366",1356,1038,4382,151,161,312
"18367",1159,836,4382,34,39,73
"18368",2117,1950,4385,87,100,187
"18369",2258,2001,4386,47,51,98
"18370",1212,1058,4388,36,43,79
"18371",1255,1138,4388,77,83,160
"18372",1312,1133,4388,94,78,172
"18373",1426,1234,4389,72,94,166
"18374",1420,1227,4389,64,87,151
"18375",1556,1343,4389,160,163,323
"18376",1812,1609,4389,298,309,607
"18377",2056,1847,4390,195,198,393
"18378",2156,1935,4391,49,45,94
"18379",2307,2100,4391,122,130,252
"18380",2130,2034,4392,86,89,175
"18381",132,2159,4393,124,132,256
"18382",2400,2030,4393,49,60,109
"18383",33,2107,4393,82,97,179
"18384",2358,2018,4393,47,48,95
"18385",2204,1855,4395,43,60,103
"18386",1133,817,4396,31,42,73
"18387",1254,906,4396,110,91,201
"18388",1149,829,4396,45,54,99
"18389",1721,1354,4396,384,384,768
"18390",1551,1151,4397,110,81,191
"18391",1546,1215,4397,105,105,210
"18392",1816,1412,4398,255,237,492
"18393",1810,1426,4398,251,251,502
"18394",1609,1232,4398,128,137,265
"18395",1001,840,4399,68,75,143
"18396",1537,1416,4399,412,416,828
"18397",1557,1427,4401,69,67,136
"18398",1521,1400,4401,33,40,73
"18399",1706,1543,4401,140,143,283
"18400",2225,2055,4402,43,40,83
"18401",41,2326,4402,179,191,370
"18402",2113,2001,4403,71,51,122
"18403",1205,1052,4404,34,42,76
"18404",1130,753,4407,53,43,96
"18405",1530,1154,4408,84,89,173
"18406",1740,1359,4408,214,212,426
"18407",1944,1642,4409,95,94,189
"18408",1855,1554,4409,46,46,92
"18409",2056,1745,4411,47,44,91
"18410",2138,1834,4411,89,93,182
"18411",2257,2003,4411,172,184,356
"18412",1229,929,4416,120,134,254
"18413",1627,1427,4416,69,97,166
"18414",2259,2121,4421,59,66,125
"18415",2240,2102,4421,50,57,107
"18416",2225,2057,4421,35,52,87
"18417",2241,2110,4421,51,65,116
"18418",3,2227,4421,133,142,275
"18419",2005,1711,4422,47,51,98
"18420",1710,1555,4427,404,417,821
"18421",1548,1424,4429,46,56,102
"18422",1630,1510,4429,88,102,190
"18423",1920,1748,4429,260,260,520
"18424",1750,1624,4430,88,91,179
"18425",1814,1633,4430,117,105,222
"18426",2212,2053,4431,81,93,174
"18427",2141,2028,4431,50,68,118
"18428",2134,2016,4431,43,56,99
"18429",2219,2057,4431,88,97,185
"18430",2308,2149,4431,139,149,288
"18431",1738,1448,4433,31,42,73
"18432",1741,1446,4433,34,40,74
"18433",1804,1512,4433,57,66,123
"18434",1533,1156,4434,83,89,172
"18435",2033,1739,4436,64,74,138
"18436",2023,1725,4436,54,60,114
"18437",1604,1432,4437,260,262,522
"18438",1740,1558,4437,353,343,696
"18439",1127,1003,4438,59,48,107
"18440",1608,1437,4438,97,97,194
"18441",1925,1754,4439,91,94,185
"18442",1929,1758,4439,95,98,193
"18443",2023,1855,4439,151,155,306
"18444",1227,1122,4442,64,77,141
"18445",1833,1654,4443,239,229,468
"18446",1508,1350,4443,34,45,79
"18447",1725,1601,4443,173,176,349
"18448",2232,2118,4444,90,108,198
"18449",2259,2129,4449,67,69,136
"18450",2256,2120,4449,64,60,124
"18451",2334,2206,4449,102,106,208
"18452",137,4,4449,225,224,449
"18453",1814,1722,4453,122,130,252
"18454",18,2121,4456,82,86,168
"18455",1031,932,4456,35,37,72
"18456",1823,1631,4459,55,56,111
"18457",1815,1635,4459,47,60,107
"18458",2007,1905,4459,239,245,484
"18459",1752,1537,4464,59,57,116
"18460",1842,1640,4464,109,120,229
"18461",2136,2043,4466,69,78,147
"18462",2144,2046,4466,77,81,158
"18463",2217,2102,4466,110,97,207
"18464",1416,1304,4467,148,152,300
"18465",2132,1749,4473,62,45,107
"18466",2125,1803,4473,71,73,144
"18467",2230,1929,4481,109,119,228
"18468",2115,1816,4481,36,46,82
"18469",1836,1703,4482,76,88,164
"18470",1543,1441,4488,159,166,325
"18471",10,2211,4493,263,281,544
"18472",1937,1749,4494,105,114,219
"18473",1726,1537,4504,322,317,639
"18474",1432,1257,4504,130,137,267
"18475",1327,1147,4504,83,87,170
"18476",1807,1504,4507,296,294,590
"18477",1339,1252,4508,66,72,138
"18478",1323,1235,4508,50,55,105
"18479",1337,1253,4508,64,73,137
"18480",1316,1231,4508,43,51,94
"18481",1921,1713,4509,48,76,124
"18482",2131,1914,4509,185,204,389
"18483",2339,2117,4509,313,327,640
"18484",2343,1935,4509,69,45,114
"18485",2344,2014,4509,70,84,154
"18486",1800,1459,4511,80,89,169
"18487",2314,2016,4512,40,56,96
"18488",2344,2045,4512,62,75,137
"18489",2338,2037,4512,64,77,141
"18490",2312,2017,4512,38,57,95
"18491",1421,1326,4518,99,106,205
"18492",2116,1955,4522,92,65,157
"18493",2037,1928,4522,53,38,91
"18494",2043,1933,4522,59,43,102
"18495",2112,2020,4522,88,90,178
"18496",2024,1933,4522,42,43,85
"18497",2338,1957,4525,54,67,121
"18498",2325,2024,4525,52,59,111
"18499",1746,1419,4528,79,53,132
"18500",2250,1938,4529,57,43,100
"18501",2400,2103,4529,127,128,255
"18502",2233,1930,4529,40,35,75
"18503",2310,2007,4529,77,72,149
"18504",2322,2021,4529,89,86,175
"18505",2226,1935,4529,33,40,73
"18506",2103,1753,4532,43,68,111
"18507",2316,1944,4532,176,179,355
"18508",2120,1802,4532,34,46,80
"18509",2224,2035,4533,149,160,309
"18510",2057,1900,4533,62,65,127
"18511",2251,2058,4533,176,183,359
"18512",1800,1451,4535,59,56,115
"18513",1744,1441,4535,68,71,139
"18514",2304,2122,4540,113,137,250
"18515",2221,2036,4540,70,91,161
"18516",2246,2050,4540,95,105,200
"18517",1602,1250,4542,102,110,212
"18518",1500,1140,4542,40,40,80
"18519",1513,1157,4542,53,57,110
"18520",2317,2211,4544,158,171,329
"18521",2224,2125,4544,105,125,230
"18522",1634,1442,4547,139,132,271
"18523",1852,1707,4547,277,277,554
"18524",1519,1341,4547,64,71,135
"18525",2112,1751,4547,35,52,87
"18526",2049,1733,4547,36,58,94
"18527",38,2322,4551,160,137,297
"18528",2332,2246,4551,94,101,195
"18529",1516,1413,4553,57,63,120
"18530",1503,1140,4553,61,55,116
"18531",1547,1226,4553,105,101,206
"18532",1448,1132,4553,46,47,93
"18533",2026,1732,4554,31,37,68
"18534",2118,1820,4554,83,85,168
"18535",2105,1817,4554,70,82,152
"18536",2145,1858,4554,110,123,233
"18537",2129,2005,4554,32,40,72
"18538",1742,1612,4560,68,37,105
"18539",1927,1831,4561,48,51,99
"18540",1232,1039,4562,77,84,161
"18541",1547,1344,4562,272,269,541
"18542",1618,1434,4562,303,319,622
"18543",1846,1538,4563,68,83,151
"18544",1613,1339,4566,32,44,76
"18545",2008,1720,4566,39,47,86
"18546",2056,1755,4566,87,82,169
"18547",2024,1735,4566,55,62,117
"18548",2241,1942,4566,192,189,381
"18549",1906,1600,4567,324,330,654
"18550",7,2307,4573,284,292,576
"18551",104,2147,4573,67,65,132
"18552",2358,2050,4573,40,45,85
"18553",59,2206,4573,49,71,120
"18554",24,2112,4573,34,37,71
"18555",30,2125,4573,40,50,90
"18556",1321,1219,4574,59,59,118
"18557",1252,919,4575,85,69,154
"18558",1306,1003,4575,73,87,160
"18559",1711,1535,4577,67,75,142
"18560",1701,1517,4577,57,57,114
"18561",1729,1553,4577,85,93,178
"18562",1739,1607,4577,95,107,202
"18563",1042,942,4578,37,42,79
"18564",1104,1009,4578,59,69,128
"18565",1443,1341,4579,87,96,183
"18566",1759,1656,4579,285,291,576
"18567",1515,1413,4579,119,128,247
"18568",2218,2045,4580,39,40,79
"18569",2211,2039,4580,55,59,114
"18570",2313,2127,4580,117,107,224
"18571",1404,1249,4582,53,54,107
"18572",1447,1338,4582,96,103,199
"18573",1545,1436,4582,156,161,317
"18574",2225,2033,4584,72,63,135
"18575",2256,2112,4584,105,102,207
"18576",2007,1859,4585,100,109,209
"18577",1904,1750,4585,37,40,77
"18578",1956,1827,4585,89,77,166
"18579",2350,2246,4586,81,86,167
"18580",29,2328,4586,120,128,248
"18581",2329,2227,4586,60,67,127
"18582",2237,2141,4587,108,131,239
"18583",14,2207,4588,179,192,371
"18584",2317,2116,4588,122,141,263
"18585",18,2220,4594,149,170,319
"18586",2305,2127,4595,40,32,72
"18587",2321,2150,4595,56,55,111
"18588",2340,2220,4595,75,85,160
"18589",129,5,4599,169,175,344
"18590",15,2105,4601,58,55,113
"18591",2357,2055,4601,40,45,85
"18592",1307,1116,4602,234,246,480
"18593",1509,1320,4602,356,370,726
"18594",1648,1338,4603,73,79,152
"18595",1804,1451,4603,149,152,301
"18596",1616,1300,4603,41,41,82
"18597",1941,1635,4607,32,38,70
"18598",1814,1519,4607,31,46,77
"18599",1815,1503,4607,60,58,118
"18600",1907,1559,4607,112,114,226
"18601",1820,1523,4607,67,78,145
"18602",1502,1204,4608,75,84,159
"18603",1722,1423,4608,215,223,438
"18604",1444,1138,4608,57,58,115
"18605",1612,1246,4608,145,126,271
"18606",1707,1408,4608,202,208,410
"18607",1129,956,4611,71,71,142
"18608",1457,1328,4611,281,283,564
"18609",1725,1427,4612,106,87,193
"18610",1620,1528,4614,49,58,107
"18611",1609,1514,4614,38,44,82
"18612",1657,1559,4614,86,89,175
"18613",1701,1603,4614,90,93,183
"18614",1624,1533,4614,53,63,116
"18615",1903,1804,4615,60,61,121
"18616",2015,1923,4615,99,108,207
"18617",1915,1817,4615,39,42,81
"18618",2110,2022,4615,155,167,322
"18619",1611,1309,4616,153,123,276
"18620",1650,1409,4616,192,183,375
"18621",1420,1148,4616,44,42,86
"18622",1710,1525,4619,39,34,73
"18623",1425,1108,4621,83,63,146
"18624",1703,1406,4621,243,241,484
"18625",1800,1636,4626,46,36,82
"18626",1916,1801,4628,162,159,321
"18627",1726,1614,4628,52,52,104
"18628",1801,1652,4628,87,90,177
"18629",1827,1722,4628,115,120,235
"18630",1708,1608,4628,34,46,80
"18631",2123,1930,4629,31,38,69
"18632",2348,2152,4629,178,182,360
"18633",2222,2037,4629,92,107,199
"18634",1205,927,4635,59,37,96
"18635",1146,935,4635,40,45,85
"18636",2221,2057,4637,81,87,168
"18637",2247,2113,4637,107,103,210
"18638",2252,2117,4637,112,107,219
"18639",1807,1636,4641,127,138,265
"18640",1710,1529,4641,70,71,141
"18641",2324,1934,4641,52,40,92
"18642",2043,1905,4642,40,45,85
"18643",2051,1901,4642,48,41,89
"18644",1555,1428,4647,170,183,353
"18645",2229,2110,4648,72,65,137
"18646",1428,1128,4651,60,68,128
"18647",1359,1101,4651,31,41,72
"18648",1435,1115,4651,67,55,122
"18649",938,807,4654,33,37,70
"18650",1104,835,4654,119,65,184
"18651",1754,1416,4654,40,44,84
"18652",1934,1551,4654,142,139,281
"18653",1827,1643,4657,39,33,72
"18654",1810,1436,4657,39,44,83
"18655",1823,1429,4657,52,37,89
"18656",1815,1438,4657,39,41,80
"18657",2049,1914,4658,61,64,125
"18658",2046,1909,4658,58,59,117
"18659",2241,2149,4658,38,39,77
"18660",2258,2212,4658,55,62,117
"18661",2323,2233,4658,80,83,163
"18662",2237,2100,4659,88,90,178
"18663",2345,2221,4659,125,137,262
"18664",48,2134,4659,61,64,125
"18665",43,2138,4659,63,73,136
"18666",1824,1703,4662,32,38,70
"18667",1849,1727,4662,57,62,119
"18668",1915,1754,4662,80,86,166
"18669",1848,1725,4662,69,73,142
"18670",1101,908,4663,103,103,206
"18671",57,2131,4669,144,136,280
"18672",1217,846,4670,81,96,177
"18673",1541,1404,4671,85,94,179
"18674",2321,2146,4674,57,71,128
"18675",2241,2056,4674,32,36,68
"18676",2327,2130,4674,78,70,148
"18677",2256,2102,4674,47,42,89
"18678",2304,2122,4674,55,62,117
"18679",2232,2049,4674,67,79,146
"18680",2248,2112,4674,83,102,185
"18681",1109,920,4676,112,115,227
"18682",1024,841,4676,67,76,143
"18683",1002,810,4676,45,45,90
"18684",1001,800,4676,44,35,79
"18685",2324,2219,4676,47,54,101
"18686",20,2317,4676,103,112,215
"18687",1514,1358,4678,36,48,84
"18688",1529,1402,4678,51,52,103
"18689",2040,1859,4681,78,88,166
"18690",2012,1823,4681,51,53,104
"18691",2205,2014,4681,164,164,328
"18692",2015,1830,4681,54,60,114
"18693",2001,1814,4681,40,44,84
"18694",2049,1900,4681,90,90,180
"18695",1357,1302,4683,57,62,119
"18696",1919,1545,4690,310,310,620
"18697",1735,1409,4690,208,214,422
"18698",1745,1630,4696,113,117,230
"18699",1738,1603,4696,119,103,222
"18700",1632,1509,4696,53,49,102
"18701",1640,1537,4696,61,77,138
"18702",1752,1647,4696,135,147,282
"18703",1602,1256,4698,104,121,225
"18704",1638,1321,4698,138,146,284
"18705",2326,2035,4701,54,65,119
"18706",2249,1944,4701,50,49,99
"18707",2246,1935,4701,47,40,87
"18708",2237,1934,4701,38,39,77
"18709",1811,1457,4704,54,57,111
"18710",2237,1900,4704,89,100,189
"18711",2317,1928,4704,131,128,259
"18712",2354,2101,4705,41,56,97
"18713",1534,1324,4706,34,34,68
"18714",1621,1415,4706,81,85,166
"18715",1846,1540,4708,40,38,78
"18716",40,2350,4710,43,50,93
"18717",136,48,4710,99,108,207
"18718",101,4,4710,64,64,128
"18719",1548,1301,4712,89,91,180
"18720",1508,1247,4712,49,77,126
"18721",1603,1319,4712,104,109,213
"18722",1740,1511,4712,203,221,424
"18723",1341,1206,5906,124,133,257
"18724",1156,1035,5906,32,50,82
"18725",1703,1533,5906,326,340,666
"18726",1330,1136,5256,54,56,110
"18727",2318,2128,5257,68,88,156
"18728",2303,2123,5257,53,83,136
"18729",2116,1955,5246,136,145,281
"18730",2012,1838,5246,35,33,68
"18731",2109,1912,5246,92,67,159
"18732",1846,1623,5248,39,53,92
"18733",1658,1510,5249,122,130,252
"18734",1527,1331,5249,31,31,62
"18735",1608,1421,5249,72,81,153
"18736",2218,2012,5188,44,77,121
"18737",1401,1213,5157,221,188,409
"18738",1938,1837,5158,48,67,115
"18739",2011,1907,5159,84,97,181
"18740",1937,1819,5159,50,49,99
"18741",1835,1537,5159,44,47,91
"18742",1900,1556,5159,69,66,135
"18743",1928,1609,5159,97,79,176
"18744",1002,853,5239,69,63,132
"18745",937,838,5239,44,48,92
"18746",2014,1905,5240,88,79,167
"18747",2212,2112,5241,91,97,188
"18748",2207,2100,5241,86,85,171
"18749",2133,2038,5241,52,63,115
"18750",950,844,5241,61,54,115
"18751",955,853,5241,66,63,129
"18752",2158,2058,5242,46,48,94
"18753",2145,2045,5242,33,35,68
"18754",1619,1520,5243,146,150,296
"18755",1435,1336,5243,42,46,88
"18756",2016,1916,5244,76,76,152
"18757",1759,1657,5245,107,103,210
"18758",1645,1549,5245,33,35,68
"18759",1655,1558,5245,43,44,87
"18760",1857,1725,5245,110,110,220
"18761",1758,1620,5245,51,45,96
"18762",1743,1622,5245,36,47,83
"18763",105,2356,5235,156,166,322
"18764",1956,1819,5238,58,44,102
"18765",1600,1345,5195,41,40,81
"18766",1711,1519,5196,37,45,82
"18767",1259,1147,5199,99,107,206
"18768",1204,1038,5199,44,38,82
"18769",1334,1231,5199,134,151,285
"18770",2126,2019,5200,111,124,235
"18771",2012,1906,5200,37,51,88
"18772",1158,1041,5200,38,41,79
"18773",1512,1142,5202,71,72,143
"18774",1510,1134,5202,69,64,133
"18775",1639,1321,5202,160,171,331
"18776",1433,1120,5202,34,50,84
"18777",1612,1342,5203,54,52,106
"18778",1624,1354,5204,151,149,300
"18779",1507,1303,5204,74,98,172
"18780",1200,1034,5205,44,64,108
"18781",1229,1051,5205,73,81,154
"18782",1157,1016,5205,41,46,87
"18783",1208,1013,5205,52,43,95
"18784",1141,937,5205,61,35,96
"18785",1853,1732,5206,148,167,315
"18786",2212,2032,5207,170,177,347
"18787",2116,1951,5207,114,136,250
"18788",1953,1806,5207,31,31,62
"18789",1913,1623,5190,35,38,73
"18790",1921,1631,5190,43,46,89
"18791",2355,2123,5191,110,128,238
"18792",2011,1739,5192,92,114,206
"18793",1225,1129,3277,85,89,174
"18794",44,2348,5178,130,148,278
"18795",2119,1736,5178,41,46,87
"18796",1701,1537,5180,32,31,63
"18797",1240,1137,5180,37,37,74
"18798",1341,1230,5180,98,90,188
"18799",1554,1459,5180,231,239,470
"18800",1110,1005,5182,34,50,84
"18801",1609,1217,5182,35,32,67
"18802",1621,1226,5182,45,41,86
"18803",1650,1300,5182,74,75,149
"18804",2308,2147,5183,39,37,76
"18805",1534,1232,5184,35,34,69
"18806",1629,1329,5184,90,91,181
"18807",1831,1527,5184,77,87,164
"18808",1748,1438,5184,66,68,134
"18809",102,2112,5185,127,137,264
"18810",9,2018,5185,74,83,157
"18811",1638,1446,5185,99,106,205
"18812",1641,1443,5185,102,103,205
"18813",9,2218,5162,47,63,110
"18814",27,2246,5163,87,96,183
"18815",16,2251,5163,76,101,177
"18816",2350,2225,5163,50,75,125
"18817",1651,1359,5164,51,69,120
"18818",1917,1603,5164,200,201,401
"18819",1852,1545,5165,49,50,99
"18820",1956,1704,5165,113,129,242
"18821",2149,2051,5166,66,85,151
"18822",39,2359,5168,52,59,111
"18823",1401,1245,5169,226,235,461
"18824",1202,1047,5169,105,117,222
"18825",1941,1822,5170,38,42,80
"18826",1642,1330,5171,38,40,78
"18827",929,832,5172,60,77,137
"18828",2009,1826,5172,147,164,311
"18829",1224,1035,5173,39,40,79
"18830",1227,1051,5173,42,56,98
"18831",2257,2153,5175,43,58,101
"18832",1516,1140,5177,73,85,158
"18833",1617,1230,5177,132,135,267
"18834",1447,1215,5216,32,45,77
"18835",2321,2134,5217,53,44,97
"18836",1244,1059,5218,184,204,388
"18837",1958,1834,5223,43,54,97
"18838",1326,1043,5224,59,83,142
"18839",2021,1904,5224,210,214,424
"18840",1800,1640,5224,69,70,139
"18841",1323,1017,5226,44,41,85
"18842",1329,1017,5226,50,41,91
"18843",1330,1028,5226,51,52,103
"18844",1216,907,5227,115,112,227
"18845",1057,759,5227,36,44,80
"18846",1151,853,5227,90,98,188
"18847",1302,1207,5229,61,67,128
"18848",1436,1345,5229,169,180,349
"18849",1513,1336,5337,252,269,521
"18850",1139,1005,5337,38,58,96
"18851",1157,1027,5337,56,80,136
"18852",1459,1321,5440,80,96,176
"18853",1623,1455,5440,164,190,354
"18854",12,2030,6278,84,90,174
"18855",106,2130,6278,138,150,288
"18856",1848,1446,312,50,44,94
"18857",1639,1528,460,126,148,274
"18858",1532,1415,460,59,75,134
"18859",2313,2057,480,179,202,381
"18860",1853,1502,552,54,58,112
"18861",1856,1511,552,55,65,120
"18862",1841,1443,552,42,39,81
"18863",2138,1859,637,84,84,168
"18864",1440,1153,639,121,103,224
"18865",1312,1050,639,33,40,73
"18866",1310,1039,639,41,39,80
"18867",1202,1019,855,44,82,126
"18868",1618,1248,1702,56,48,104
"18869",1941,1613,1978,36,34,70
"18870",1505,1140,1170,79,75,154
"18871",2227,1818,1828,31,33,64
"18872",2125,1933,247,85,93,178
"18873",1108,738,1696,43,38,81
"18874",2340,2133,278,45,33,78
"18875",1848,1457,1824,87,107,194
"18876",1433,1116,1170,47,51,98
"18877",1150,754,1820,84,99,183
"18878",1823,1424,1824,62,74,136
"18879",2314,1849,1828,78,64,142
"18880",1529,1153,1170,103,88,191
"18881",2150,1818,1679,45,38,83
"18882",1717,1351,1702,115,111,226
"18883",2334,1935,1828,88,100,188
"18884",1812,1356,1824,51,46,97
"18885",2314,1912,1828,68,77,145
"18886",1624,1302,1170,158,157,315
"18887",1925,1750,623,156,175,331
"18888",1632,1514,495,47,59,106
"18889",2349,1946,112,114,131,245
"18890",2131,2036,218,46,61,107
"18891",2241,2034,1568,36,69,105
"18892",1913,1806,513,33,46,79
"18893",1546,1410,1098,36,55,91
"18894",1909,1743,31,129,133,262
"18895",1909,1817,261,44,52,96
"18896",2334,1925,112,99,110,209
"18897",1703,1555,988,88,90,178
"18898",1946,1826,513,66,66,132
"18899",2306,2023,1191,106,133,239
"18900",1818,1709,3090,88,94,182
"18901",1736,1642,1939,61,67,128
"18902",1705,1515,1442,95,100,195
"18903",1904,1821,2698,44,51,95
"18904",2128,2035,1131,63,60,123
"18905",1602,1516,3890,42,46,88
"18906",1506,1406,1677,41,36,77
"18907",36,2041,1160,161,186,347
"18908",121,2227,2926,46,57,103
"18909",1415,1208,3374,35,48,83
"18910",1830,1439,2072,110,129,239
"18911",1424,1322,1741,39,32,71
"18912",2132,2022,2189,67,52,119
"18913",1504,1356,787,54,61,115
"18914",1739,1647,40,39,47,86
"18915",1635,1535,988,60,70,130
"18916",1111,1014,1254,46,49,95
"18917",1710,1613,405,45,43,88
"18918",1412,1316,994,32,31,63
"18919",1852,1711,1050,57,76,133
"18920",2256,2139,1288,46,59,105
"18921",1620,1528,27,65,63,128
"18922",2107,2015,47,42,45,87
"18923",1117,1024,8,137,144,281
"18924",1701,1612,38,36,42,78
"18925",1734,1637,40,34,37,71
"18926",2049,1957,48,104,117,221
"18927",1925,1820,261,60,55,115
"18928",2347,1939,112,112,124,236
"18929",1202,1055,9,42,35,77
"18930",1911,1753,513,31,33,64
"18931",1749,1352,3085,59,72,131
"18932",2046,1850,39,71,70,141
"18933",1845,1723,33,70,78,148
